""," Total: "," Income in the past 12 months below poverty level: "," Income in the past 12 months below poverty level: In married-couple family: "," Income in the past 12 months below poverty level: In married-couple family: Under 5 years "," Income in the past 12 months below poverty level: In married-couple family: 5 years "," Income in the past 12 months below poverty level: In married-couple family: 6 to 17 years "," Income in the past 12 months below poverty level: In other family: "," Income in the past 12 months below poverty level: In other family: Male householder, no wife present: "," Income in the past 12 months below poverty level: In other family: Male householder, no wife present: Under 5 years "," Income in the past 12 months below poverty level: In other family: Male householder, no wife present: 5 years "," Income in the past 12 months below poverty level: In other family: Male householder, no wife present: 6 to 17 years "," Income in the past 12 months below poverty level: In other family: Female householder, no husband present: "," Income in the past 12 months below poverty level: In other family: Female householder, no husband present: Under 5 years "," Income in the past 12 months below poverty level: In other family: Female householder, no husband present: 5 years "," Income in the past 12 months below poverty level: In other family: Female householder, no husband present: 6 to 17 years "," Income in the past 12 months at or above poverty level: "," Income in the past 12 months at or above poverty level: In married-couple family: "," Income in the past 12 months at or above poverty level: In married-couple family: Under 5 years "," Income in the past 12 months at or above poverty level: In married-couple family: 5 years "," Income in the past 12 months at or above poverty level: In married-couple family: 6 to 17 years "," Income in the past 12 months at or above poverty level: In other family: "," Income in the past 12 months at or above poverty level: In other family: Male householder, no wife present: "," Income in the past 12 months at or above poverty level: In other family: Male householder, no wife present: Under 5 years "," Income in the past 12 months at or above poverty level: In other family: Male householder, no wife present: 5 years "," Income in the past 12 months at or above poverty level: In other family: Male householder, no wife present: 6 to 17 years "," Income in the past 12 months at or above poverty level: In other family: Female householder, no husband present: "," Income in the past 12 months at or above poverty level: In other family: Female householder, no husband present: Under 5 years "," Income in the past 12 months at or above poverty level: In other family: Female householder, no husband present: 5 years "," Income in the past 12 months at or above poverty level: In other family: Female householder, no husband present: 6 to 17 years ","geoid","tract"
"1",1343,596,66,0,0,66,530,83,0,0,83,447,103,62,282,747,499,258,25,216,248,62,62,0,0,186,44,0,142,"17031010100","010100"
"2",1985,1051,528,282,43,203,523,62,32,0,30,461,147,39,275,934,462,179,0,283,472,0,0,0,0,472,180,0,292,"17031010201","010201"
"3",411,190,41,41,0,0,149,0,0,0,0,149,91,0,58,221,157,116,17,24,64,16,0,0,16,48,0,0,48,"17031010202","010202"
"4",965,335,127,67,45,15,208,0,0,0,0,208,33,0,175,630,436,259,19,158,194,107,61,0,46,87,58,14,15,"17031010300","010300"
"5",465,68,68,68,0,0,0,0,0,0,0,0,0,0,0,397,293,115,33,145,104,16,0,0,16,88,62,0,26,"17031010400","010400"
"6",401,128,0,0,0,0,128,27,0,0,27,101,17,0,84,273,152,97,0,55,121,0,0,0,0,121,11,0,110,"17031010501","010501"
"7",196,0,0,0,0,0,0,0,0,0,0,0,0,0,0,196,102,64,24,14,94,45,28,0,17,49,0,0,49,"17031010502","010502"
"8",99,0,0,0,0,0,0,0,0,0,0,0,0,0,0,99,90,41,31,18,9,0,0,0,0,9,0,0,9,"17031010503","010503"
"9",1258,438,109,75,34,0,329,0,0,0,0,329,64,49,216,820,433,142,15,276,387,75,18,0,57,312,124,0,188,"17031010600","010600"
"10",924,66,62,14,0,48,4,0,0,0,0,4,1,0,3,858,495,223,8,264,363,151,96,0,55,212,40,0,172,"17031010701","010701"
"11",1448,512,221,77,0,144,291,7,7,0,0,284,22,23,239,936,852,297,24,531,84,39,0,0,39,45,14,0,31,"17031010702","010702"
"12",1272,625,310,113,53,144,315,130,12,0,118,185,43,40,102,647,523,141,22,360,124,63,0,0,63,61,32,0,29,"17031020100","020100"
"13",1576,370,311,86,0,225,59,0,0,0,0,59,0,0,59,1206,1049,373,93,583,157,16,0,0,16,141,34,21,86,"17031020200","020200"
"14",1454,42,0,0,0,0,42,9,0,0,9,33,17,0,16,1412,1216,276,57,883,196,107,48,13,46,89,15,0,74,"17031020301","020301"
"15",892,152,125,82,0,43,27,0,0,0,0,27,9,0,18,740,646,141,86,419,94,0,0,0,0,94,0,16,78,"17031020302","020302"
"16",1052,92,69,0,21,48,23,0,0,0,0,23,11,10,2,960,773,202,34,537,187,27,19,0,8,160,13,16,131,"17031020400","020400"
"17",1519,482,165,65,0,100,317,0,0,0,0,317,0,0,317,1037,854,191,166,497,183,40,28,0,12,143,30,16,97,"17031020500","020500"
"18",2100,515,376,112,58,206,139,47,47,0,0,92,27,0,65,1585,1450,447,41,962,135,54,0,0,54,81,71,10,0,"17031020601","020601"
"19",994,431,324,93,4,227,107,0,0,0,0,107,85,0,22,563,521,228,0,293,42,24,0,0,24,18,0,0,18,"17031020602","020602"
"20",469,227,169,83,0,86,58,43,0,0,43,15,0,0,15,242,213,123,9,81,29,0,0,0,0,29,8,7,14,"17031020701","020701"
"21",2128,679,282,0,15,267,397,253,130,0,123,144,52,0,92,1449,1395,459,126,810,54,15,15,0,0,39,24,0,15,"17031020702","020702"
"22",940,441,266,80,20,166,175,15,15,0,0,160,0,0,160,499,393,152,0,241,106,0,0,0,0,106,69,0,37,"17031020801","020801"
"23",1845,701,492,114,0,378,209,104,69,0,35,105,0,0,105,1144,996,450,49,497,148,20,0,0,20,128,0,0,128,"17031020802","020802"
"24",1433,662,364,100,38,226,298,104,54,38,12,194,8,0,186,771,576,166,62,348,195,171,91,0,80,24,9,0,15,"17031020901","020901"
"25",881,246,237,81,0,156,9,0,0,0,0,9,0,0,9,635,562,206,50,306,73,34,34,0,0,39,32,0,7,"17031020902","020902"
"26",319,139,0,0,0,0,139,34,0,0,34,105,11,0,94,180,106,51,0,55,74,49,37,12,0,25,0,0,25,"17031030101","030101"
"27",177,12,0,0,0,0,12,0,0,0,0,12,0,0,12,165,97,27,8,62,68,0,0,0,0,68,35,0,33,"17031030102","030102"
"28",118,0,0,0,0,0,0,0,0,0,0,0,0,0,0,118,118,7,0,111,0,0,0,0,0,0,0,0,0,"17031030103","030103"
"29",84,0,0,0,0,0,0,0,0,0,0,0,0,0,0,84,84,39,0,45,0,0,0,0,0,0,0,0,0,"17031030104","030104"
"30",929,0,0,0,0,0,0,0,0,0,0,0,0,0,0,929,661,268,36,357,268,159,42,40,77,109,31,0,78,"17031030200","030200"
"31",617,198,41,41,0,0,157,71,0,0,71,86,44,0,42,419,385,100,10,275,34,0,0,0,0,34,34,0,0,"17031030300","030300"
"32",475,174,60,50,0,10,114,0,0,0,0,114,9,0,105,301,201,120,11,70,100,26,0,0,26,74,33,0,41,"17031030400","030400"
"33",1333,410,262,59,0,203,148,0,0,0,0,148,78,0,70,923,654,297,0,357,269,35,35,0,0,234,17,10,207,"17031030500","030500"
"34",197,90,0,0,0,0,90,90,30,0,60,0,0,0,0,107,79,33,0,46,28,0,0,0,0,28,0,0,28,"17031030601","030601"
"35",305,64,0,0,0,0,64,0,0,0,0,64,0,0,64,241,135,0,14,121,106,0,0,0,0,106,0,0,106,"17031030603","030603"
"36",175,43,17,0,0,17,26,0,0,0,0,26,0,0,26,132,95,29,0,66,37,37,0,0,37,0,0,0,0,"17031030604","030604"
"37",265,74,0,0,0,0,74,46,46,0,0,28,28,0,0,191,33,17,0,16,158,20,20,0,0,138,0,0,138,"17031030701","030701"
"38",92,0,0,0,0,0,0,0,0,0,0,0,0,0,0,92,63,23,0,40,29,0,0,0,0,29,0,0,29,"17031030702","030702"
"39",189,0,0,0,0,0,0,0,0,0,0,0,0,0,0,189,148,148,0,0,41,41,11,0,30,0,0,0,0,"17031030703","030703"
"40",271,61,0,0,0,0,61,0,0,0,0,61,61,0,0,210,144,122,22,0,66,0,0,0,0,66,39,0,27,"17031030706","030706"
"41",618,231,0,0,0,0,231,0,0,0,0,231,0,0,231,387,260,84,0,176,127,127,127,0,0,0,0,0,0,"17031030800","030800"
"42",471,8,0,0,0,0,8,0,0,0,0,8,0,8,0,463,392,296,65,31,71,47,0,0,47,24,16,0,8,"17031030900","030900"
"43",313,12,12,12,0,0,0,0,0,0,0,0,0,0,0,301,247,87,12,148,54,0,0,0,0,54,0,0,54,"17031031000","031000"
"44",334,0,0,0,0,0,0,0,0,0,0,0,0,0,0,334,145,130,0,15,189,25,25,0,0,164,29,0,135,"17031031100","031100"
"45",751,417,137,0,0,137,280,0,0,0,0,280,0,62,218,334,277,128,0,149,57,33,33,0,0,24,24,0,0,"17031031200","031200"
"46",899,282,35,27,4,4,247,14,14,0,0,233,95,15,123,617,487,215,13,259,130,26,9,0,17,104,58,0,46,"17031031300","031300"
"47",329,30,0,0,0,0,30,0,0,0,0,30,0,0,30,299,185,109,0,76,114,0,0,0,0,114,49,18,47,"17031031400","031400"
"48",306,154,74,74,0,0,80,14,0,0,14,66,38,0,28,152,124,106,9,9,28,22,0,0,22,6,0,0,6,"17031031501","031501"
"49",845,357,160,91,22,47,197,34,0,0,34,163,67,10,86,488,255,79,12,164,233,82,0,28,54,151,40,0,111,"17031031502","031502"
"50",786,467,67,13,0,54,400,0,0,0,0,400,133,0,267,319,266,216,0,50,53,0,0,0,0,53,0,0,53,"17031031700","031700"
"51",206,41,36,18,0,18,5,0,0,0,0,5,5,0,0,165,137,39,0,98,28,13,0,0,13,15,0,0,15,"17031031800","031800"
"52",248,70,0,0,0,0,70,0,0,0,0,70,21,0,49,178,178,66,16,96,0,0,0,0,0,0,0,0,0,"17031031900","031900"
"53",701,111,94,49,0,45,17,0,0,0,0,17,17,0,0,590,471,318,12,141,119,0,0,0,0,119,0,0,119,"17031032100","032100"
"54",667,61,61,0,0,61,0,0,0,0,0,0,0,0,0,606,549,135,8,406,57,20,10,10,0,37,0,0,37,"17031040100","040100"
"55",869,176,111,38,0,73,65,0,0,0,0,65,0,0,65,693,583,366,15,202,110,0,0,0,0,110,0,0,110,"17031040201","040201"
"56",1343,539,486,151,41,294,53,0,0,0,0,53,28,0,25,804,622,374,64,184,182,58,0,0,58,124,14,0,110,"17031040202","040202"
"57",410,52,0,0,0,0,52,0,0,0,0,52,32,0,20,358,352,151,13,188,6,0,0,0,0,6,0,0,6,"17031040300","040300"
"58",608,81,81,28,0,53,0,0,0,0,0,0,0,0,0,527,393,185,51,157,134,15,0,0,15,119,41,0,78,"17031040401","040401"
"59",449,13,0,0,0,0,13,0,0,0,0,13,0,0,13,436,320,214,17,89,116,25,0,12,13,91,40,0,51,"17031040402","040402"
"60",410,6,0,0,0,0,6,0,0,0,0,6,6,0,0,404,368,161,29,178,36,0,0,0,0,36,36,0,0,"17031040600","040600"
"61",359,9,9,0,0,9,0,0,0,0,0,0,0,0,0,350,309,201,5,103,41,8,8,0,0,33,33,0,0,"17031040700","040700"
"62",307,0,0,0,0,0,0,0,0,0,0,0,0,0,0,307,258,68,6,184,49,0,0,0,0,49,21,0,28,"17031040800","040800"
"63",289,15,0,0,0,0,15,0,0,0,0,15,0,0,15,274,266,105,0,161,8,0,0,0,0,8,0,0,8,"17031040900","040900"
"64",512,0,0,0,0,0,0,0,0,0,0,0,0,0,0,512,505,241,31,233,7,0,0,0,0,7,0,0,7,"17031050100","050100"
"65",801,0,0,0,0,0,0,0,0,0,0,0,0,0,0,801,657,397,63,197,144,38,0,0,38,106,0,0,106,"17031050200","050200"
"66",353,7,0,0,0,0,7,7,0,0,7,0,0,0,0,346,305,96,22,187,41,20,0,10,10,21,13,0,8,"17031050300","050300"
"67",1064,0,0,0,0,0,0,0,0,0,0,0,0,0,0,1064,955,375,27,553,109,0,0,0,0,109,0,0,109,"17031050500","050500"
"68",283,0,0,0,0,0,0,0,0,0,0,0,0,0,0,283,253,102,0,151,30,0,0,0,0,30,30,0,0,"17031050600","050600"
"69",205,0,0,0,0,0,0,0,0,0,0,0,0,0,0,205,167,77,5,85,38,6,0,0,6,32,0,0,32,"17031050700","050700"
"70",265,17,17,17,0,0,0,0,0,0,0,0,0,0,0,248,248,127,25,96,0,0,0,0,0,0,0,0,0,"17031050800","050800"
"71",467,0,0,0,0,0,0,0,0,0,0,0,0,0,0,467,427,296,19,112,40,10,0,0,10,30,0,0,30,"17031050900","050900"
"72",257,17,7,0,0,7,10,0,0,0,0,10,5,0,5,240,214,153,22,39,26,17,0,0,17,9,0,0,9,"17031051000","051000"
"73",296,35,35,0,0,35,0,0,0,0,0,0,0,0,0,261,220,170,5,45,41,31,0,0,31,10,0,0,10,"17031051100","051100"
"74",340,19,0,0,0,0,19,0,0,0,0,19,0,0,19,321,321,178,23,120,0,0,0,0,0,0,0,0,0,"17031051200","051200"
"75",615,68,37,37,0,0,31,9,9,0,0,22,0,0,22,547,510,296,41,173,37,16,0,0,16,21,0,6,15,"17031051300","051300"
"76",476,40,0,0,0,0,40,0,0,0,0,40,0,13,27,436,395,226,45,124,41,11,11,0,0,30,11,0,19,"17031051400","051400"
"77",474,18,0,0,0,0,18,0,0,0,0,18,0,0,18,456,416,217,21,178,40,8,4,0,4,32,18,0,14,"17031060100","060100"
"78",148,37,37,8,0,29,0,0,0,0,0,0,0,0,0,111,101,52,0,49,10,0,0,0,0,10,0,0,10,"17031060200","060200"
"79",689,9,0,0,0,0,9,0,0,0,0,9,0,0,9,680,467,235,17,215,213,30,0,0,30,183,0,7,176,"17031060300","060300"
"80",1011,53,0,0,0,0,53,0,0,0,0,53,0,0,53,958,950,440,87,423,8,0,0,0,0,8,0,0,8,"17031060400","060400"
"81",90,0,0,0,0,0,0,0,0,0,0,0,0,0,0,90,90,17,11,62,0,0,0,0,0,0,0,0,0,"17031060500","060500"
"82",331,0,0,0,0,0,0,0,0,0,0,0,0,0,0,331,331,128,15,188,0,0,0,0,0,0,0,0,0,"17031060800","060800"
"83",527,0,0,0,0,0,0,0,0,0,0,0,0,0,0,527,527,250,23,254,0,0,0,0,0,0,0,0,0,"17031060900","060900"
"84",99,0,0,0,0,0,0,0,0,0,0,0,0,0,0,99,94,61,33,0,5,0,0,0,0,5,5,0,0,"17031061000","061000"
"85",61,0,0,0,0,0,0,0,0,0,0,0,0,0,0,61,51,39,0,12,10,10,0,0,10,0,0,0,0,"17031061100","061100"
"86",234,0,0,0,0,0,0,0,0,0,0,0,0,0,0,234,228,141,0,87,6,6,6,0,0,0,0,0,0,"17031061200","061200"
"87",222,0,0,0,0,0,0,0,0,0,0,0,0,0,0,222,208,117,15,76,14,14,0,14,0,0,0,0,0,"17031061500","061500"
"88",41,11,6,0,0,6,5,0,0,0,0,5,0,0,5,30,13,9,4,0,17,17,0,0,17,0,0,0,0,"17031061800","061800"
"89",355,0,0,0,0,0,0,0,0,0,0,0,0,0,0,355,169,43,86,40,186,131,0,63,68,55,55,0,0,"17031061901","061901"
"90",202,0,0,0,0,0,0,0,0,0,0,0,0,0,0,202,149,35,12,102,53,16,0,0,16,37,0,0,37,"17031061902","061902"
"91",162,9,0,0,0,0,9,0,0,0,0,9,0,0,9,153,106,59,4,43,47,47,26,0,21,0,0,0,0,"17031062000","062000"
"92",244,0,0,0,0,0,0,0,0,0,0,0,0,0,0,244,236,177,6,53,8,0,0,0,0,8,8,0,0,"17031062100","062100"
"93",313,10,0,0,0,0,10,0,0,0,0,10,0,10,0,303,295,182,27,86,8,0,0,0,0,8,0,8,0,"17031062200","062200"
"94",287,54,0,0,0,0,54,0,0,0,0,54,0,0,54,233,233,91,16,126,0,0,0,0,0,0,0,0,0,"17031062300","062300"
"95",299,2,0,0,0,0,2,0,0,0,0,2,1,0,1,297,297,161,30,106,0,0,0,0,0,0,0,0,0,"17031062400","062400"
"96",109,16,16,11,5,0,0,0,0,0,0,0,0,0,0,93,88,66,0,22,5,5,0,0,5,0,0,0,0,"17031062500","062500"
"97",601,114,68,0,17,51,46,46,24,0,22,0,0,0,0,487,464,277,40,147,23,0,0,0,0,23,0,0,23,"17031062600","062600"
"98",478,56,0,0,0,0,56,56,38,0,18,0,0,0,0,422,310,128,32,150,112,81,73,0,8,31,0,0,31,"17031062700","062700"
"99",527,16,16,8,8,0,0,0,0,0,0,0,0,0,0,511,494,230,51,213,17,8,8,0,0,9,0,0,9,"17031062800","062800"
"100",353,0,0,0,0,0,0,0,0,0,0,0,0,0,0,353,323,249,48,26,30,0,0,0,0,30,9,0,21,"17031062900","062900"
"101",218,0,0,0,0,0,0,0,0,0,0,0,0,0,0,218,177,117,31,29,41,27,0,0,27,14,0,0,14,"17031063000","063000"
"102",206,0,0,0,0,0,0,0,0,0,0,0,0,0,0,206,201,115,28,58,5,0,0,0,0,5,5,0,0,"17031063100","063100"
"103",337,105,0,0,0,0,105,0,0,0,0,105,0,37,68,232,232,169,0,63,0,0,0,0,0,0,0,0,0,"17031063200","063200"
"104",32,0,0,0,0,0,0,0,0,0,0,0,0,0,0,32,32,32,0,0,0,0,0,0,0,0,0,0,0,"17031063301","063301"
"105",223,0,0,0,0,0,0,0,0,0,0,0,0,0,0,223,223,151,12,60,0,0,0,0,0,0,0,0,0,"17031063302","063302"
"106",32,0,0,0,0,0,0,0,0,0,0,0,0,0,0,32,32,24,0,8,0,0,0,0,0,0,0,0,0,"17031063303","063303"
"107",66,0,0,0,0,0,0,0,0,0,0,0,0,0,0,66,58,28,0,30,8,0,0,0,0,8,0,8,0,"17031063400","063400"
"108",588,0,0,0,0,0,0,0,0,0,0,0,0,0,0,588,552,116,0,436,36,36,0,0,36,0,0,0,0,"17031070101","070101"
"109",103,0,0,0,0,0,0,0,0,0,0,0,0,0,0,103,93,93,0,0,10,0,0,0,0,10,0,0,10,"17031070102","070102"
"110",112,33,24,0,0,24,9,0,0,0,0,9,9,0,0,79,58,58,0,0,21,21,21,0,0,0,0,0,0,"17031070103","070103"
"111",487,16,0,0,0,0,16,0,0,0,0,16,16,0,0,471,471,171,14,286,0,0,0,0,0,0,0,0,0,"17031070200","070200"
"112",288,0,0,0,0,0,0,0,0,0,0,0,0,0,0,288,244,165,8,71,44,18,0,0,18,26,12,0,14,"17031070300","070300"
"113",592,0,0,0,0,0,0,0,0,0,0,0,0,0,0,592,574,267,26,281,18,18,9,0,9,0,0,0,0,"17031070400","070400"
"114",437,0,0,0,0,0,0,0,0,0,0,0,0,0,0,437,424,221,8,195,13,13,0,13,0,0,0,0,0,"17031070500","070500"
"115",567,0,0,0,0,0,0,0,0,0,0,0,0,0,0,567,567,259,37,271,0,0,0,0,0,0,0,0,0,"17031070600","070600"
"116",854,17,0,0,0,0,17,0,0,0,0,17,0,0,17,837,797,362,77,358,40,0,0,0,0,40,11,0,29,"17031070700","070700"
"117",194,7,0,0,0,0,7,0,0,0,0,7,7,0,0,187,155,91,0,64,32,0,0,0,0,32,27,0,5,"17031071000","071000"
"118",327,0,0,0,0,0,0,0,0,0,0,0,0,0,0,327,285,87,27,171,42,0,0,0,0,42,42,0,0,"17031071100","071100"
"119",322,20,0,0,0,0,20,12,0,0,12,8,4,0,4,302,281,107,4,170,21,0,0,0,0,21,0,0,21,"17031071200","071200"
"120",535,0,0,0,0,0,0,0,0,0,0,0,0,0,0,535,526,91,26,409,9,0,0,0,0,9,0,0,9,"17031071300","071300"
"121",514,43,0,0,0,0,43,0,0,0,0,43,43,0,0,471,462,143,28,291,9,0,0,0,0,9,9,0,0,"17031071400","071400"
"122",448,44,0,0,0,0,44,9,0,0,9,35,17,0,18,404,331,197,0,134,73,0,0,0,0,73,0,0,73,"17031071500","071500"
"123",292,30,16,16,0,0,14,0,0,0,0,14,0,0,14,262,255,103,14,138,7,7,0,0,7,0,0,0,0,"17031071600","071600"
"124",396,75,0,0,0,0,75,0,0,0,0,75,51,0,24,321,228,74,21,133,93,15,0,0,15,78,7,0,71,"17031071700","071700"
"125",528,14,0,0,0,0,14,0,0,0,0,14,0,0,14,514,405,188,41,176,109,21,0,0,21,88,34,0,54,"17031071800","071800"
"126",678,30,30,0,0,30,0,0,0,0,0,0,0,0,0,648,599,230,24,345,49,0,0,0,0,49,49,0,0,"17031080100","080100"
"127",164,0,0,0,0,0,0,0,0,0,0,0,0,0,0,164,164,38,0,126,0,0,0,0,0,0,0,0,0,"17031080201","080201"
"128",269,0,0,0,0,0,0,0,0,0,0,0,0,0,0,269,242,148,2,92,27,0,0,0,0,27,0,0,27,"17031080202","080202"
"129",443,48,0,0,0,0,48,0,0,0,0,48,17,0,31,395,310,180,40,90,85,0,0,0,0,85,12,0,73,"17031080300","080300"
"130",1376,1111,0,0,0,0,1111,0,0,0,0,1111,208,40,863,265,265,72,56,137,0,0,0,0,0,0,0,0,0,"17031080400","080400"
"131",184,0,0,0,0,0,0,0,0,0,0,0,0,0,0,184,32,0,11,21,152,25,25,0,0,127,102,0,25,"17031081000","081000"
"132",43,0,0,0,0,0,0,0,0,0,0,0,0,0,0,43,43,43,0,0,0,0,0,0,0,0,0,0,0,"17031081100","081100"
"133",129,0,0,0,0,0,0,0,0,0,0,0,0,0,0,129,129,50,15,64,0,0,0,0,0,0,0,0,0,"17031081201","081201"
"134",241,0,0,0,0,0,0,0,0,0,0,0,0,0,0,241,104,49,0,55,137,0,0,0,0,137,67,32,38,"17031081202","081202"
"135",182,0,0,0,0,0,0,0,0,0,0,0,0,0,0,182,168,168,0,0,14,0,0,0,0,14,0,0,14,"17031081300","081300"
"136",104,0,0,0,0,0,0,0,0,0,0,0,0,0,0,104,104,41,0,63,0,0,0,0,0,0,0,0,0,"17031081401","081401"
"137",202,0,0,0,0,0,0,0,0,0,0,0,0,0,0,202,81,15,0,66,121,0,0,0,0,121,56,0,65,"17031081402","081402"
"138",366,0,0,0,0,0,0,0,0,0,0,0,0,0,0,366,366,247,16,103,0,0,0,0,0,0,0,0,0,"17031081403","081403"
"139",214,29,0,0,0,0,29,0,0,0,0,29,0,0,29,185,161,104,0,57,24,24,12,0,12,0,0,0,0,"17031081500","081500"
"140",197,40,40,40,0,0,0,0,0,0,0,0,0,0,0,157,157,116,0,41,0,0,0,0,0,0,0,0,0,"17031081600","081600"
"141",256,51,0,0,0,0,51,0,0,0,0,51,0,0,51,205,163,108,0,55,42,42,42,0,0,0,0,0,0,"17031081700","081700"
"142",337,0,0,0,0,0,0,0,0,0,0,0,0,0,0,337,317,222,71,24,20,20,0,0,20,0,0,0,0,"17031081800","081800"
"143",274,188,0,0,0,0,188,0,0,0,0,188,57,0,131,86,50,45,0,5,36,0,0,0,0,36,36,0,0,"17031081900","081900"
"144",570,9,0,0,0,0,9,0,0,0,0,9,0,0,9,561,466,74,22,370,95,8,0,0,8,87,9,0,78,"17031090100","090100"
"145",1237,0,0,0,0,0,0,0,0,0,0,0,0,0,0,1237,1099,232,38,829,138,20,0,0,20,118,0,0,118,"17031090200","090200"
"146",302,22,22,11,0,11,0,0,0,0,0,0,0,0,0,280,248,101,0,147,32,6,6,0,0,26,10,0,16,"17031090300","090300"
"147",1362,0,0,0,0,0,0,0,0,0,0,0,0,0,0,1362,1147,473,16,658,215,45,45,0,0,170,50,0,120,"17031100100","100100"
"148",1281,20,0,0,0,0,20,0,0,0,0,20,0,0,20,1261,849,153,107,589,412,89,70,0,19,323,189,0,134,"17031100200","100200"
"149",1047,20,20,0,0,20,0,0,0,0,0,0,0,0,0,1027,813,190,58,565,214,113,0,0,113,101,50,0,51,"17031100300","100300"
"150",636,93,93,32,0,61,0,0,0,0,0,0,0,0,0,543,494,181,36,277,49,49,7,0,42,0,0,0,0,"17031100400","100400"
"151",1232,0,0,0,0,0,0,0,0,0,0,0,0,0,0,1232,1088,242,28,818,144,15,0,0,15,129,35,36,58,"17031100500","100500"
"152",1033,72,28,7,0,21,44,0,0,0,0,44,0,0,44,961,784,205,81,498,177,0,0,0,0,177,18,11,148,"17031100600","100600"
"153",765,151,141,25,0,116,10,0,0,0,0,10,0,0,10,614,516,166,35,315,98,10,10,0,0,88,0,11,77,"17031100700","100700"
"154",1575,102,61,31,0,30,41,0,0,0,0,41,0,0,41,1473,1377,552,61,764,96,23,0,0,23,73,0,12,61,"17031110100","110100"
"155",618,176,38,0,10,28,138,0,0,0,0,138,20,0,118,442,400,54,10,336,42,7,0,0,7,35,0,0,35,"17031110200","110200"
"156",1120,25,19,10,0,9,6,0,0,0,0,6,0,0,6,1095,975,248,145,582,120,106,27,0,79,14,0,0,14,"17031110300","110300"
"157",726,0,0,0,0,0,0,0,0,0,0,0,0,0,0,726,674,230,10,434,52,6,0,0,6,46,0,0,46,"17031110400","110400"
"158",1156,28,28,14,0,14,0,0,0,0,0,0,0,0,0,1128,802,258,40,504,326,140,74,0,66,186,51,0,135,"17031110501","110501"
"159",634,166,75,17,16,42,91,62,43,7,12,29,10,0,19,468,440,137,0,303,28,0,0,0,0,28,8,0,20,"17031110502","110502"
"160",997,9,0,0,0,0,9,0,0,0,0,9,0,0,9,988,970,251,60,659,18,8,0,0,8,10,0,0,10,"17031120100","120100"
"161",1177,0,0,0,0,0,0,0,0,0,0,0,0,0,0,1177,1063,363,131,569,114,0,0,0,0,114,0,0,114,"17031120200","120200"
"162",1453,80,40,14,0,26,40,0,0,0,0,40,40,0,0,1373,1102,304,40,758,271,179,68,0,111,92,9,15,68,"17031120300","120300"
"163",869,148,107,34,18,55,41,21,0,0,21,20,0,0,20,721,721,164,1,556,0,0,0,0,0,0,0,0,0,"17031120400","120400"
"164",1295,79,62,32,15,15,17,0,0,0,0,17,0,0,17,1216,1102,157,91,854,114,49,0,0,49,65,26,0,39,"17031130100","130100"
"165",350,11,11,11,0,0,0,0,0,0,0,0,0,0,0,339,252,58,6,188,87,16,8,8,0,71,17,0,54,"17031130200","130200"
"166",1253,225,73,32,41,0,152,0,0,0,0,152,55,18,79,1028,718,234,42,442,310,96,32,0,64,214,18,18,178,"17031130300","130300"
"167",931,381,227,111,18,98,154,18,0,0,18,136,0,29,107,550,280,117,17,146,270,206,78,21,107,64,0,19,45,"17031140100","140100"
"168",935,373,373,88,0,285,0,0,0,0,0,0,0,0,0,562,237,37,10,190,325,257,68,34,155,68,27,0,41,"17031140200","140200"
"169",617,235,58,33,0,25,177,25,7,0,18,152,50,0,102,382,292,113,5,174,90,0,0,0,0,90,13,0,77,"17031140301","140301"
"170",1277,568,436,202,48,186,132,0,0,0,0,132,26,0,106,709,584,83,34,467,125,51,19,0,32,74,21,0,53,"17031140302","140302"
"171",1936,547,508,202,25,281,39,0,0,0,0,39,0,0,39,1389,1092,446,0,646,297,0,0,0,0,297,17,16,264,"17031140400","140400"
"172",1041,258,229,91,4,134,29,29,8,0,21,0,0,0,0,783,578,206,35,337,205,115,55,21,39,90,0,0,90,"17031140500","140500"
"173",1008,323,131,0,33,98,192,0,0,0,0,192,17,0,175,685,610,185,55,370,75,0,0,0,0,75,0,0,75,"17031140601","140601"
"174",1701,616,327,73,0,254,289,238,136,30,72,51,0,0,51,1085,839,227,72,540,246,35,20,0,15,211,92,0,119,"17031140602","140602"
"175",415,58,38,27,0,11,20,11,5,0,6,9,0,0,9,357,323,79,17,227,34,14,0,0,14,20,0,9,11,"17031140701","140701"
"176",1613,412,114,50,17,47,298,0,0,0,0,298,46,7,245,1201,758,281,36,441,443,227,185,26,16,216,28,0,188,"17031140702","140702"
"177",1558,315,136,43,0,93,179,0,0,0,0,179,105,0,74,1243,1179,451,39,689,64,40,40,0,0,24,10,0,14,"17031140800","140800"
"178",1691,700,129,40,0,89,571,37,0,37,0,534,108,38,388,991,867,297,56,514,124,17,0,0,17,107,14,0,93,"17031150200","150200"
"179",1428,226,157,31,0,126,69,40,21,19,0,29,0,0,29,1202,763,126,53,584,439,0,0,0,0,439,215,32,192,"17031150300","150300"
"180",883,251,27,0,0,27,224,0,0,0,0,224,29,0,195,632,419,76,37,306,213,78,25,0,53,135,0,20,115,"17031150401","150401"
"181",711,161,0,0,0,0,161,39,39,0,0,122,44,0,78,550,421,61,36,324,129,0,0,0,0,129,4,0,125,"17031150402","150402"
"182",806,36,20,0,0,20,16,0,0,0,0,16,11,0,5,770,713,206,49,458,57,0,0,0,0,57,31,0,26,"17031150501","150501"
"183",1059,118,118,0,0,118,0,0,0,0,0,0,0,0,0,941,573,220,19,334,368,46,0,0,46,322,151,0,171,"17031150502","150502"
"184",1020,277,21,7,0,14,256,0,0,0,0,256,29,0,227,743,639,174,17,448,104,20,4,0,16,84,28,0,56,"17031150600","150600"
"185",1064,90,90,15,0,75,0,0,0,0,0,0,0,0,0,974,756,243,58,455,218,150,0,18,132,68,0,0,68,"17031150700","150700"
"186",1200,272,105,0,0,105,167,9,9,0,0,158,22,0,136,928,846,237,87,522,82,11,0,0,11,71,22,0,49,"17031150800","150800"
"187",616,490,15,0,0,15,475,0,0,0,0,475,129,24,322,126,40,19,0,21,86,76,39,0,37,10,10,0,0,"17031151001","151001"
"188",1235,239,189,26,0,163,50,14,0,0,14,36,0,0,36,996,737,282,113,342,259,55,55,0,0,204,77,29,98,"17031151002","151002"
"189",1262,317,88,26,13,49,229,0,0,0,0,229,81,49,99,945,690,252,42,396,255,51,19,10,22,204,16,22,166,"17031151100","151100"
"190",728,55,26,16,0,10,29,0,0,0,0,29,0,0,29,673,598,119,42,437,75,11,0,0,11,64,33,0,31,"17031151200","151200"
"191",670,0,0,0,0,0,0,0,0,0,0,0,0,0,0,670,445,104,62,279,225,114,38,25,51,111,0,0,111,"17031160100","160100"
"192",911,6,6,6,0,0,0,0,0,0,0,0,0,0,0,905,725,269,8,448,180,0,0,0,0,180,60,0,120,"17031160200","160200"
"193",654,297,28,28,0,0,269,258,34,34,190,11,11,0,0,357,328,121,80,127,29,0,0,0,0,29,29,0,0,"17031160300","160300"
"194",993,383,43,0,0,43,340,180,72,0,108,160,70,21,69,610,500,177,7,316,110,33,0,0,33,77,0,0,77,"17031160400","160400"
"195",1208,402,301,77,21,203,101,0,0,0,0,101,24,18,59,806,517,221,58,238,289,121,16,0,105,168,17,21,130,"17031160501","160501"
"196",1135,219,113,53,0,60,106,26,26,0,0,80,41,0,39,916,636,225,0,411,280,226,137,59,30,54,0,0,54,"17031160502","160502"
"197",1100,49,19,0,0,19,30,0,0,0,0,30,30,0,0,1051,751,406,18,327,300,300,55,74,171,0,0,0,0,"17031160601","160601"
"198",941,207,37,0,0,37,170,127,65,0,62,43,0,0,43,734,439,142,26,271,295,91,0,0,91,204,0,0,204,"17031160602","160602"
"199",1331,123,0,0,0,0,123,0,0,0,0,123,123,0,0,1208,1007,199,82,726,201,0,0,0,0,201,80,46,75,"17031160700","160700"
"200",1304,236,137,85,0,52,99,0,0,0,0,99,3,0,96,1068,837,269,15,553,231,47,35,0,12,184,29,0,155,"17031160800","160800"
"201",573,13,0,0,0,0,13,0,0,0,0,13,13,0,0,560,372,53,26,293,188,0,0,0,0,188,39,19,130,"17031160900","160900"
"202",400,49,6,0,0,6,43,0,0,0,0,43,26,0,17,351,339,95,13,231,12,0,0,0,0,12,0,0,12,"17031161000","161000"
"203",643,22,2,0,0,2,20,0,0,0,0,20,20,0,0,621,586,269,34,283,35,0,0,0,0,35,0,3,32,"17031161100","161100"
"204",769,45,29,0,0,29,16,6,0,0,6,10,0,10,0,724,508,223,42,243,216,58,34,0,24,158,63,0,95,"17031161200","161200"
"205",800,186,102,33,17,52,84,0,0,0,0,84,0,0,84,614,484,221,6,257,130,46,16,0,30,84,0,0,84,"17031161300","161300"
"206",202,13,0,0,0,0,13,0,0,0,0,13,0,0,13,189,101,43,8,50,88,0,0,0,0,88,8,0,80,"17031170100","170100"
"207",557,42,0,0,0,0,42,42,42,0,0,0,0,0,0,515,378,66,29,283,137,10,10,0,0,127,8,27,92,"17031170200","170200"
"208",969,301,67,30,0,37,234,10,0,0,10,224,42,0,182,668,550,213,25,312,118,84,0,44,40,34,7,0,27,"17031170300","170300"
"209",700,197,160,36,14,110,37,0,0,0,0,37,0,0,37,503,443,112,8,323,60,6,0,0,6,54,9,0,45,"17031170400","170400"
"210",805,48,28,28,0,0,20,0,0,0,0,20,20,0,0,757,589,193,61,335,168,62,0,0,62,106,0,0,106,"17031170500","170500"
"211",545,60,0,0,0,0,60,0,0,0,0,60,31,0,29,485,403,159,9,235,82,71,0,0,71,11,8,3,0,"17031170600","170600"
"212",635,136,37,0,0,37,99,0,0,0,0,99,31,0,68,499,482,149,66,267,17,17,0,0,17,0,0,0,0,"17031170700","170700"
"213",658,128,9,9,0,0,119,0,0,0,0,119,50,0,69,530,438,111,32,295,92,0,0,0,0,92,40,16,36,"17031170800","170800"
"214",424,19,0,0,0,0,19,19,0,0,19,0,0,0,0,405,218,46,25,147,187,19,0,0,19,168,4,23,141,"17031170900","170900"
"215",1534,120,53,53,0,0,67,0,0,0,0,67,52,0,15,1414,953,138,44,771,461,196,127,0,69,265,70,0,195,"17031171000","171000"
"216",1046,42,42,12,8,22,0,0,0,0,0,0,0,0,0,1004,827,215,31,581,177,128,32,44,52,49,13,0,36,"17031171100","171100"
"217",1218,212,145,13,14,118,67,33,0,0,33,34,11,0,23,1006,822,379,0,443,184,14,0,0,14,170,11,15,144,"17031180100","180100"
"218",666,133,45,12,5,28,88,0,0,0,0,88,31,0,57,533,249,30,43,176,284,138,70,23,45,146,27,0,119,"17031190100","190100"
"219",1755,723,309,148,27,134,414,129,0,23,106,285,48,21,216,1032,569,180,25,364,463,180,0,16,164,283,116,0,167,"17031190200","190200"
"220",955,312,116,22,0,94,196,0,0,0,0,196,0,0,196,643,430,174,33,223,213,135,42,0,93,78,39,0,39,"17031190300","190300"
"221",1058,159,56,12,18,26,103,0,0,0,0,103,49,0,54,899,574,227,51,296,325,52,39,0,13,273,86,41,146,"17031190401","190401"
"222",1257,432,214,60,12,142,218,64,64,0,0,154,91,0,63,825,500,131,38,331,325,129,66,0,63,196,52,21,123,"17031190402","190402"
"223",1508,539,314,105,0,209,225,0,0,0,0,225,64,0,161,969,531,225,0,306,438,217,132,0,85,221,51,20,150,"17031190601","190601"
"224",1454,536,0,0,0,0,536,79,20,0,59,457,184,106,167,918,681,204,17,460,237,69,36,19,14,168,0,44,124,"17031190602","190602"
"225",822,31,0,0,0,0,31,0,0,0,0,31,0,0,31,791,533,79,53,401,258,85,30,0,55,173,64,15,94,"17031190701","190701"
"226",1460,393,234,0,0,234,159,75,48,18,9,84,47,0,37,1067,465,128,15,322,602,382,147,0,235,220,53,0,167,"17031190702","190702"
"227",2110,416,140,46,0,94,276,59,21,18,20,217,33,0,184,1694,1261,285,135,841,433,115,21,43,51,318,64,0,254,"17031190800","190800"
"228",534,217,62,0,16,46,155,0,0,0,0,155,19,0,136,317,167,25,4,138,150,0,0,0,0,150,52,0,98,"17031190900","190900"
"229",786,253,183,61,11,111,70,10,0,0,10,60,38,0,22,533,386,72,24,290,147,40,16,14,10,107,34,0,73,"17031191000","191000"
"230",2416,825,193,0,0,193,632,163,141,0,22,469,137,19,313,1591,1115,251,68,796,476,205,97,20,88,271,68,0,203,"17031191100","191100"
"231",1546,658,393,184,12,197,265,172,69,30,73,93,34,0,59,888,541,134,37,370,347,40,0,0,40,307,88,10,209,"17031191200","191200"
"232",1722,535,372,124,0,248,163,43,0,0,43,120,23,0,97,1187,763,155,91,517,424,336,119,32,185,88,36,0,52,"17031191301","191301"
"233",1937,612,260,34,33,193,352,0,0,0,0,352,34,19,299,1325,894,112,0,782,431,340,93,23,224,91,16,0,75,"17031191302","191302"
"234",1311,248,135,13,0,122,113,0,0,0,0,113,77,0,36,1063,810,308,49,453,253,36,14,0,22,217,75,0,142,"17031200100","200100"
"235",1444,370,149,59,0,90,221,29,0,0,29,192,19,18,155,1074,676,223,8,445,398,54,31,0,23,344,12,8,324,"17031200200","200200"
"236",640,281,43,5,9,29,238,172,95,40,37,66,0,19,47,359,223,18,7,198,136,42,18,0,24,94,42,9,43,"17031200300","200300"
"237",1322,430,180,78,14,88,250,61,0,16,45,189,44,0,145,892,635,126,59,450,257,51,12,0,39,206,69,13,124,"17031200401","200401"
"238",995,329,17,17,0,0,312,62,31,0,31,250,133,0,117,666,588,291,52,245,78,12,0,0,12,66,12,0,54,"17031200402","200402"
"239",707,187,133,48,0,85,54,28,10,0,18,26,0,0,26,520,381,204,56,121,139,51,18,0,33,88,12,0,76,"17031210100","210100"
"240",637,172,87,32,0,55,85,0,0,0,0,85,13,0,72,465,402,172,14,216,63,0,0,0,0,63,18,8,37,"17031210400","210400"
"241",1144,286,171,115,0,56,115,0,0,0,0,115,88,0,27,858,592,171,34,387,266,117,34,0,83,149,24,0,125,"17031210501","210501"
"242",1366,463,306,44,0,262,157,0,0,0,0,157,59,0,98,903,556,212,15,329,347,26,26,0,0,321,34,28,259,"17031210502","210502"
"243",601,57,57,29,0,28,0,0,0,0,0,0,0,0,0,544,507,165,18,324,37,0,0,0,0,37,0,9,28,"17031210601","210601"
"244",934,276,42,0,0,42,234,0,0,0,0,234,120,9,105,658,526,226,36,264,132,12,0,0,12,120,55,26,39,"17031210602","210602"
"245",728,95,29,29,0,0,66,0,0,0,0,66,12,0,54,633,495,267,7,221,138,0,0,0,0,138,38,27,73,"17031210700","210700"
"246",270,96,62,36,0,26,34,0,0,0,0,34,0,0,34,174,98,17,18,63,76,68,36,8,24,8,8,0,0,"17031210800","210800"
"247",582,58,34,8,0,26,24,0,0,0,0,24,0,0,24,524,469,209,0,260,55,0,0,0,0,55,0,0,55,"17031210900","210900"
"248",454,54,0,0,0,0,54,0,0,0,0,54,5,0,49,400,159,91,2,66,241,50,50,0,0,191,21,29,141,"17031220300","220300"
"249",536,26,26,26,0,0,0,0,0,0,0,0,0,0,0,510,271,60,9,202,239,179,58,0,121,60,34,0,26,"17031220400","220400"
"250",305,108,0,0,0,0,108,32,32,0,0,76,33,0,43,197,162,105,5,52,35,0,0,0,0,35,31,4,0,"17031220500","220500"
"251",233,33,0,0,0,0,33,14,0,0,14,19,5,0,14,200,130,52,5,73,70,15,0,0,15,55,55,0,0,"17031220601","220601"
"252",549,189,78,0,39,39,111,0,0,0,0,111,111,0,0,360,310,210,9,91,50,13,13,0,0,37,0,0,37,"17031220602","220602"
"253",1062,398,213,71,0,142,185,0,0,0,0,185,83,0,102,664,327,65,18,244,337,163,40,0,123,174,27,66,81,"17031220701","220701"
"254",1296,372,81,8,0,73,291,30,30,0,0,261,80,18,163,924,656,115,84,457,268,115,26,0,89,153,79,23,51,"17031220702","220702"
"255",979,431,242,68,16,158,189,103,28,0,75,86,4,0,82,548,358,65,15,278,190,16,0,0,16,174,41,0,133,"17031220901","220901"
"256",1015,491,173,48,0,125,318,43,6,0,37,275,33,53,189,524,442,124,50,268,82,57,0,0,57,25,0,0,25,"17031220902","220902"
"257",858,300,137,29,5,103,163,21,0,0,21,142,10,21,111,558,321,80,4,237,237,22,10,0,12,215,36,0,179,"17031221000","221000"
"258",733,339,141,75,0,66,198,36,0,0,36,162,34,15,113,394,208,33,19,156,186,18,18,0,0,168,56,0,112,"17031221100","221100"
"259",534,131,50,0,0,50,81,22,22,0,0,59,7,0,52,403,241,121,0,120,162,40,0,0,40,122,40,0,82,"17031221200","221200"
"260",454,191,62,22,0,40,129,19,19,0,0,110,81,0,29,263,214,83,27,104,49,0,0,0,0,49,17,12,20,"17031221300","221300"
"261",598,250,139,28,25,86,111,51,26,0,25,60,0,0,60,348,203,51,21,131,145,145,60,0,85,0,0,0,0,"17031221400","221400"
"262",232,21,0,0,0,0,21,0,0,0,0,21,0,0,21,211,153,68,25,60,58,0,0,0,0,58,0,0,58,"17031221500","221500"
"263",600,72,22,0,0,22,50,0,0,0,0,50,26,24,0,528,478,223,40,215,50,8,8,0,0,42,0,12,30,"17031221600","221600"
"264",336,0,0,0,0,0,0,0,0,0,0,0,0,0,0,336,299,183,10,106,37,25,13,0,12,12,0,0,12,"17031222200","222200"
"265",270,109,20,0,20,0,89,0,0,0,0,89,24,0,65,161,124,44,0,80,37,10,10,0,0,27,0,5,22,"17031222500","222500"
"266",255,21,0,0,0,0,21,0,0,0,0,21,0,0,21,234,109,22,3,84,125,53,21,0,32,72,37,9,26,"17031222600","222600"
"267",767,386,161,101,6,54,225,34,0,0,34,191,49,22,120,381,143,40,5,98,238,78,48,0,30,160,0,16,144,"17031222700","222700"
"268",206,110,24,8,0,16,86,46,0,0,46,40,0,0,40,96,18,2,5,11,78,3,0,0,3,75,14,0,61,"17031222800","222800"
"269",236,81,64,0,0,64,17,0,0,0,0,17,17,0,0,155,130,3,0,127,25,0,0,0,0,25,0,0,25,"17031222900","222900"
"270",348,101,30,0,15,15,71,0,0,0,0,71,12,11,48,247,78,28,4,46,169,37,0,0,37,132,9,0,123,"17031230100","230100"
"271",435,127,41,20,0,21,86,0,0,0,0,86,5,5,76,308,210,33,9,168,98,0,0,0,0,98,17,0,81,"17031230200","230200"
"272",349,124,97,20,0,77,27,0,0,0,0,27,0,10,17,225,197,50,21,126,28,28,28,0,0,0,0,0,0,"17031230300","230300"
"273",724,182,15,0,6,9,167,0,0,0,0,167,59,0,108,542,331,61,9,261,211,98,21,9,68,113,10,9,94,"17031230400","230400"
"274",1198,493,72,0,8,64,421,113,33,0,80,308,33,18,257,705,581,86,0,495,124,27,27,0,0,97,26,16,55,"17031230500","230500"
"275",2476,1502,215,71,27,117,1287,72,38,0,34,1215,437,97,681,974,373,168,29,176,601,148,22,16,110,453,43,51,359,"17031230600","230600"
"276",1366,519,11,0,0,11,508,124,26,0,98,384,122,0,262,847,377,201,37,139,470,124,51,0,73,346,85,46,215,"17031230700","230700"
"277",174,7,3,0,3,0,4,0,0,0,0,4,4,0,0,167,135,25,0,110,32,26,5,0,21,6,0,0,6,"17031230800","230800"
"278",1147,693,255,98,31,126,438,36,0,0,36,402,138,10,254,454,248,103,46,99,206,14,0,0,14,192,72,10,110,"17031230900","230900"
"279",182,72,31,16,7,8,41,0,0,0,0,41,6,0,35,110,49,5,0,44,61,8,0,0,8,53,0,26,27,"17031231100","231100"
"280",1310,821,44,30,0,14,777,88,60,0,28,689,235,46,408,489,278,108,0,170,211,38,0,0,38,173,36,0,137,"17031231200","231200"
"281",1970,838,106,0,0,106,732,158,113,0,45,574,101,58,415,1132,307,0,30,277,825,150,0,39,111,675,131,55,489,"17031231500","231500"
"282",297,9,0,0,0,0,9,0,0,0,0,9,0,0,9,288,264,133,11,120,24,5,0,0,5,19,0,9,10,"17031240200","240200"
"283",254,5,0,0,0,0,5,0,0,0,0,5,0,0,5,249,233,116,16,101,16,10,0,0,10,6,0,0,6,"17031240300","240300"
"284",279,11,0,0,0,0,11,0,0,0,0,11,11,0,0,268,240,163,9,68,28,28,28,0,0,0,0,0,0,"17031240500","240500"
"285",397,252,30,0,0,30,222,0,0,0,0,222,33,0,189,145,112,102,0,10,33,0,0,0,0,33,20,0,13,"17031240600","240600"
"286",451,243,144,38,0,106,99,0,0,0,0,99,0,0,99,208,197,59,31,107,11,0,0,0,0,11,6,0,5,"17031240700","240700"
"287",417,98,8,0,0,8,90,0,0,0,0,90,29,0,61,319,160,30,27,103,159,0,0,0,0,159,29,0,130,"17031240800","240800"
"288",199,36,8,0,0,8,28,0,0,0,0,28,9,0,19,163,146,40,0,106,17,11,0,0,11,6,0,0,6,"17031240900","240900"
"289",553,248,12,8,0,4,236,0,0,0,0,236,59,5,172,305,67,37,0,30,238,36,11,0,25,202,58,0,144,"17031241000","241000"
"290",656,209,0,0,0,0,209,0,0,0,0,209,21,10,178,447,123,68,0,55,324,20,0,0,20,304,96,32,176,"17031241100","241100"
"291",365,69,0,0,0,0,69,0,0,0,0,69,17,0,52,296,283,50,29,204,13,0,0,0,0,13,0,0,13,"17031241200","241200"
"292",294,111,0,0,0,0,111,0,0,0,0,111,0,5,106,183,140,63,0,77,43,0,0,0,0,43,0,0,43,"17031241300","241300"
"293",894,153,0,0,0,0,153,0,0,0,0,153,43,0,110,741,630,504,46,80,111,13,13,0,0,98,41,0,57,"17031241400","241400"
"294",422,56,0,0,0,0,56,56,24,0,32,0,0,0,0,366,326,175,0,151,40,19,0,0,19,21,0,0,21,"17031241500","241500"
"295",253,27,17,0,0,17,10,0,0,0,0,10,0,0,10,226,184,128,0,56,42,0,0,0,0,42,12,0,30,"17031241600","241600"
"296",378,53,30,16,0,14,23,0,0,0,0,23,0,0,23,325,224,131,28,65,101,0,0,0,0,101,29,0,72,"17031242000","242000"
"297",396,8,8,8,0,0,0,0,0,0,0,0,0,0,0,388,267,185,14,68,121,30,30,0,0,91,22,0,69,"17031242100","242100"
"298",662,104,0,0,0,0,104,0,0,0,0,104,0,0,104,558,501,281,0,220,57,15,0,6,9,42,0,0,42,"17031242200","242200"
"299",381,11,0,0,0,0,11,0,0,0,0,11,0,0,11,370,263,135,35,93,107,33,15,0,18,74,30,8,36,"17031242300","242300"
"300",249,16,0,0,0,0,16,0,0,0,0,16,0,0,16,233,189,88,25,76,44,0,0,0,0,44,0,0,44,"17031242400","242400"
"301",865,191,0,0,0,0,191,0,0,0,0,191,19,19,153,674,257,97,19,141,417,55,30,0,25,362,44,67,251,"17031242500","242500"
"302",882,261,191,32,34,125,70,0,0,0,0,70,33,0,37,621,368,161,41,166,253,224,52,0,172,29,0,0,29,"17031242600","242600"
"303",457,263,0,0,0,0,263,132,0,0,132,131,45,13,73,194,32,24,0,8,162,21,13,0,8,141,43,6,92,"17031242700","242700"
"304",256,13,0,0,0,0,13,0,0,0,0,13,13,0,0,243,215,18,28,169,28,28,28,0,0,0,0,0,0,"17031242800","242800"
"305",314,64,54,27,0,27,10,0,0,0,0,10,0,0,10,250,163,137,0,26,87,65,29,0,36,22,0,0,22,"17031242900","242900"
"306",480,142,114,86,28,0,28,3,0,0,3,25,0,0,25,338,216,142,43,31,122,67,39,0,28,55,0,0,55,"17031243000","243000"
"307",489,117,49,38,0,11,68,10,10,0,0,58,30,0,28,372,308,122,27,159,64,7,0,0,7,57,0,0,57,"17031243100","243100"
"308",348,52,52,35,0,17,0,0,0,0,0,0,0,0,0,296,212,50,35,127,84,64,30,17,17,20,15,0,5,"17031243200","243200"
"309",206,31,23,12,0,11,8,0,0,0,0,8,0,0,8,175,97,58,0,39,78,37,7,0,30,41,6,0,35,"17031243300","243300"
"310",213,34,34,0,0,34,0,0,0,0,0,0,0,0,0,179,101,61,0,40,78,21,19,0,2,57,0,0,57,"17031243400","243400"
"311",507,162,0,0,0,0,162,24,24,0,0,138,52,25,61,345,272,191,11,70,73,14,0,0,14,59,0,0,59,"17031243500","243500"
"312",980,325,121,33,9,79,204,39,0,0,39,165,82,0,83,655,181,45,0,136,474,48,0,8,40,426,73,42,311,"17031250200","250200"
"313",1384,649,220,82,0,138,429,283,70,67,146,146,33,0,113,735,254,57,0,197,481,37,0,29,8,444,158,34,252,"17031250300","250300"
"314",1231,566,0,0,0,0,566,162,93,0,69,404,131,0,273,665,304,50,0,254,361,56,0,0,56,305,83,0,222,"17031250400","250400"
"315",1797,173,65,0,0,65,108,0,0,0,0,108,0,0,108,1624,1238,292,52,894,386,181,113,57,11,205,0,0,205,"17031250500","250500"
"316",1053,265,75,18,0,57,190,88,53,0,35,102,11,0,91,788,443,138,9,296,345,54,16,0,38,291,105,0,186,"17031250600","250600"
"317",1698,863,0,0,0,0,863,24,0,0,24,839,164,46,629,835,177,18,0,159,658,336,73,0,263,322,126,13,183,"17031250700","250700"
"318",521,231,39,19,0,20,192,0,0,0,0,192,28,14,150,290,110,25,0,85,180,37,0,0,37,143,5,0,138,"17031250800","250800"
"319",283,139,18,0,0,18,121,30,6,0,24,91,13,3,75,144,0,0,0,0,144,6,0,0,6,138,5,9,124,"17031251000","251000"
"320",1189,416,17,0,0,17,399,19,0,0,19,380,70,21,289,773,292,54,7,231,481,0,0,0,0,481,73,49,359,"17031251100","251100"
"321",1116,300,33,7,0,26,267,0,0,0,0,267,51,0,216,816,390,76,7,307,426,26,0,0,26,400,143,46,211,"17031251200","251200"
"322",1149,584,14,0,0,14,570,35,0,0,35,535,101,28,406,565,128,53,0,75,437,57,19,11,27,380,75,18,287,"17031251300","251300"
"323",958,478,102,13,0,89,376,41,34,0,7,335,10,0,325,480,108,0,0,108,372,7,0,7,0,365,109,0,256,"17031251400","251400"
"324",1201,391,127,41,0,86,264,16,0,0,16,248,78,0,170,810,69,0,0,69,741,50,19,0,31,691,138,0,553,"17031251500","251500"
"325",804,290,0,0,0,0,290,41,0,0,41,249,46,29,174,514,255,35,0,220,259,43,22,0,21,216,73,12,131,"17031251600","251600"
"326",663,476,102,73,29,0,374,36,14,13,9,338,81,33,224,187,35,0,0,35,152,0,0,0,0,152,47,0,105,"17031251700","251700"
"327",1534,880,135,22,0,113,745,53,36,17,0,692,280,31,381,654,201,22,0,179,453,91,42,0,49,362,92,22,248,"17031251800","251800"
"328",1781,873,50,0,0,50,823,110,44,18,48,713,246,76,391,908,338,98,0,240,570,80,0,0,80,490,54,59,377,"17031251900","251900"
"329",1949,691,19,0,0,19,672,36,0,0,36,636,288,16,332,1258,173,59,12,102,1085,139,19,31,89,946,118,64,764,"17031252000","252000"
"330",306,92,0,0,0,0,92,0,0,0,0,92,26,0,66,214,0,0,0,0,214,0,0,0,0,214,112,17,85,"17031252101","252101"
"331",1862,946,23,0,0,23,923,34,0,0,34,889,154,11,724,916,260,140,0,120,656,166,65,0,101,490,134,16,340,"17031252102","252102"
"332",400,194,0,0,0,0,194,27,0,0,27,167,78,0,89,206,113,26,0,87,93,6,6,0,0,87,33,0,54,"17031252201","252201"
"333",1457,652,119,43,20,56,533,17,0,0,17,516,220,19,277,805,274,70,4,200,531,111,34,32,45,420,121,49,250,"17031252202","252202"
"334",303,205,0,0,0,0,205,0,0,0,0,205,102,33,70,98,0,0,0,0,98,0,0,0,0,98,40,0,58,"17031260100","260100"
"335",316,186,20,7,0,13,166,0,0,0,0,166,58,4,104,130,46,10,5,31,84,37,7,0,30,47,11,0,36,"17031260200","260200"
"336",493,298,0,0,0,0,298,27,14,0,13,271,42,0,229,195,50,30,0,20,145,0,0,0,0,145,19,22,104,"17031260300","260300"
"337",565,359,0,0,0,0,359,41,0,0,41,318,146,31,141,206,96,22,18,56,110,23,0,0,23,87,28,0,59,"17031260400","260400"
"338",410,202,0,0,0,0,202,0,0,0,0,202,21,0,181,208,19,0,0,19,189,57,11,18,28,132,11,0,121,"17031260500","260500"
"339",1030,633,90,16,0,74,543,145,31,28,86,398,104,23,271,397,190,59,0,131,207,3,0,0,3,204,29,0,175,"17031260600","260600"
"340",649,440,19,10,0,9,421,62,0,0,62,359,91,14,254,209,23,12,0,11,186,15,0,0,15,171,98,0,73,"17031260700","260700"
"341",810,484,22,0,0,22,462,0,0,0,0,462,62,20,380,326,15,0,0,15,311,31,9,0,22,280,0,9,271,"17031260800","260800"
"342",562,337,20,0,0,20,317,0,0,0,0,317,151,0,166,225,0,0,0,0,225,56,38,0,18,169,19,0,150,"17031260900","260900"
"343",921,588,84,27,0,57,504,154,76,34,44,350,150,34,166,333,104,17,0,87,229,23,0,0,23,206,49,13,144,"17031261000","261000"
"344",711,446,55,9,0,46,391,84,17,0,67,307,96,34,177,265,92,55,0,37,173,5,0,0,5,168,42,0,126,"17031270500","270500"
"345",415,184,0,0,0,0,184,22,11,11,0,162,61,0,101,231,130,0,23,107,101,0,0,0,0,101,24,0,77,"17031271200","271200"
"346",398,258,0,0,0,0,258,0,0,0,0,258,44,51,163,140,25,4,0,21,115,14,5,0,9,101,5,0,96,"17031271300","271300"
"347",328,113,0,0,0,0,113,9,0,0,9,104,47,10,47,215,19,0,0,19,196,49,0,0,49,147,61,0,86,"17031271400","271400"
"348",255,189,71,0,0,71,118,0,0,0,0,118,20,0,98,66,26,18,0,8,40,16,5,0,11,24,7,0,17,"17031271500","271500"
"349",393,220,16,16,0,0,204,0,0,0,0,204,77,0,127,173,14,0,0,14,159,0,0,0,0,159,27,18,114,"17031271800","271800"
"350",309,0,0,0,0,0,0,0,0,0,0,0,0,0,0,309,251,216,17,18,58,10,0,0,10,48,48,0,0,"17031280100","280100"
"351",313,192,0,0,0,0,192,62,23,0,39,130,24,14,92,121,32,10,0,22,89,0,0,0,0,89,0,0,89,"17031280400","280400"
"352",200,112,0,0,0,0,112,0,0,0,0,112,38,8,66,88,48,18,0,30,40,6,0,0,6,34,3,3,28,"17031280800","280800"
"353",267,198,0,0,0,0,198,0,0,0,0,198,53,0,145,69,0,0,0,0,69,8,0,8,0,61,0,14,47,"17031280900","280900"
"354",162,0,0,0,0,0,0,0,0,0,0,0,0,0,0,162,162,162,0,0,0,0,0,0,0,0,0,0,0,"17031281900","281900"
"355",575,312,0,0,0,0,312,118,0,0,118,194,63,0,131,263,78,54,0,24,185,74,21,0,53,111,41,0,70,"17031282700","282700"
"356",342,14,0,0,0,0,14,0,0,0,0,14,14,0,0,328,240,166,0,74,88,0,0,0,0,88,63,8,17,"17031282800","282800"
"357",656,300,0,0,0,0,300,25,13,0,12,275,96,25,154,356,142,29,0,113,214,40,30,0,10,174,19,9,146,"17031283100","283100"
"358",222,35,0,0,0,0,35,0,0,0,0,35,5,0,30,187,52,34,0,18,135,4,4,0,0,131,35,0,96,"17031283200","283200"
"359",642,71,0,0,0,0,71,29,29,0,0,42,0,0,42,571,252,137,40,75,319,67,0,0,67,252,34,0,218,"17031283800","283800"
"360",1357,890,0,0,0,0,890,37,15,7,15,853,225,70,558,467,160,45,0,115,307,55,0,0,55,252,48,9,195,"17031290900","290900"
"361",921,621,93,0,15,78,528,6,0,0,6,522,81,6,435,300,8,0,0,8,292,0,0,0,0,292,46,11,235,"17031291200","291200"
"362",149,90,29,3,0,26,61,25,0,0,25,36,25,0,11,59,25,9,8,8,34,12,12,0,0,22,0,0,22,"17031291600","291600"
"363",859,598,51,0,0,51,547,108,0,12,96,439,56,12,371,261,58,16,0,42,203,0,0,0,0,203,32,11,160,"17031292200","292200"
"364",795,523,0,0,0,0,523,112,0,0,112,411,97,13,301,272,135,9,0,126,137,0,0,0,0,137,23,10,104,"17031292400","292400"
"365",1106,613,135,19,16,100,478,45,45,0,0,433,152,36,245,493,84,21,0,63,409,79,0,34,45,330,150,18,162,"17031292500","292500"
"366",933,262,92,36,12,44,170,34,23,0,11,136,68,0,68,671,408,136,22,250,263,153,84,0,69,110,52,0,58,"17031300500","300500"
"367",905,214,163,45,19,99,51,13,13,0,0,38,0,0,38,691,486,125,19,342,205,35,21,0,14,170,110,0,60,"17031300600","300600"
"368",1301,741,267,99,26,142,474,83,22,0,61,391,169,73,149,560,305,154,20,131,255,99,32,0,67,156,44,8,104,"17031300700","300700"
"369",1102,740,356,70,22,264,384,107,87,20,0,277,77,22,178,362,216,21,28,167,146,0,0,0,0,146,40,0,106,"17031300800","300800"
"370",933,564,106,0,8,98,458,151,18,47,86,307,53,42,212,369,177,56,0,121,192,149,39,23,87,43,0,0,43,"17031300900","300900"
"371",870,455,273,84,41,148,182,49,23,6,20,133,36,0,97,415,251,80,0,171,164,64,26,0,38,100,25,0,75,"17031301100","301100"
"372",1022,498,282,99,38,145,216,44,23,21,0,172,69,0,103,524,337,110,45,182,187,16,16,0,0,171,61,0,110,"17031301200","301200"
"373",1467,837,520,265,0,255,317,65,65,0,0,252,79,0,173,630,254,67,19,168,376,75,52,0,23,301,75,12,214,"17031301600","301600"
"374",1214,453,251,45,0,206,202,64,22,0,42,138,84,0,54,761,670,305,18,347,91,0,0,0,0,91,29,15,47,"17031301701","301701"
"375",1043,642,532,93,0,439,110,0,0,0,0,110,51,0,59,401,303,87,0,216,98,0,0,0,0,98,83,15,0,"17031301702","301702"
"376",1275,581,344,121,0,223,237,0,0,0,0,237,120,27,90,694,586,80,0,506,108,65,35,10,20,43,0,0,43,"17031301801","301801"
"377",916,275,118,12,11,95,157,0,0,0,0,157,61,5,91,641,529,161,99,269,112,0,0,0,0,112,0,0,112,"17031301802","301802"
"378",1609,757,249,29,0,220,508,305,68,0,237,203,88,29,86,852,481,135,14,332,371,174,86,36,52,197,96,0,101,"17031301803","301803"
"379",227,25,0,0,0,0,25,0,0,0,0,25,0,0,25,202,99,27,0,72,103,17,0,0,17,86,10,6,70,"17031310200","310200"
"380",134,41,0,0,0,0,41,11,0,11,0,30,0,0,30,93,69,32,4,33,24,0,0,0,0,24,0,0,24,"17031310300","310300"
"381",242,16,0,0,0,0,16,0,0,0,0,16,8,0,8,226,72,33,0,39,154,71,22,0,49,83,0,0,83,"17031310400","310400"
"382",486,313,210,105,23,82,103,82,38,0,44,21,11,0,10,173,116,38,0,78,57,48,28,10,10,9,0,0,9,"17031310500","310500"
"383",921,380,186,30,0,156,194,86,30,0,56,108,81,0,27,541,347,75,13,259,194,29,0,0,29,165,3,30,132,"17031310600","310600"
"384",124,85,0,0,0,0,85,12,12,0,0,73,25,14,34,39,39,0,0,39,0,0,0,0,0,0,0,0,0,"17031310700","310700"
"385",1130,284,166,76,18,72,118,44,23,0,21,74,28,23,23,846,556,165,53,338,290,181,61,20,100,109,49,17,43,"17031310800","310800"
"386",1398,565,220,135,22,63,345,120,90,0,30,225,72,0,153,833,414,129,31,254,419,251,85,0,166,168,32,9,127,"17031310900","310900"
"387",531,0,0,0,0,0,0,0,0,0,0,0,0,0,0,531,531,449,17,65,0,0,0,0,0,0,0,0,0,"17031320100","320100"
"388",12,0,0,0,0,0,0,0,0,0,0,0,0,0,0,12,12,7,0,5,0,0,0,0,0,0,0,0,0,"17031320400","320400"
"389",190,25,0,0,0,0,25,0,0,0,0,25,25,0,0,165,114,101,0,13,51,0,0,0,0,51,51,0,0,"17031320600","320600"
"390",1859,177,121,121,0,0,56,0,0,0,0,56,29,0,27,1682,1217,763,95,359,465,45,0,0,45,420,171,43,206,"17031330100","330100"
"391",833,51,0,0,0,0,51,41,41,0,0,10,0,0,10,782,610,370,37,203,172,61,0,0,61,111,26,11,74,"17031330200","330200"
"392",373,42,8,3,0,5,34,0,0,0,0,34,0,0,34,331,313,115,0,198,18,10,5,0,5,8,0,0,8,"17031340300","340300"
"393",315,128,128,10,62,56,0,0,0,0,0,0,0,0,0,187,112,30,18,64,75,0,0,0,0,75,0,0,75,"17031340400","340400"
"394",171,5,5,0,0,5,0,0,0,0,0,0,0,0,0,166,82,24,5,53,84,34,8,0,26,50,0,0,50,"17031340500","340500"
"395",394,359,0,0,0,0,359,13,13,0,0,346,96,11,239,35,14,0,0,14,21,0,0,0,0,21,12,0,9,"17031340600","340600"
"396",131,0,0,0,0,0,0,0,0,0,0,0,0,0,0,131,72,48,0,24,59,0,0,0,0,59,27,0,32,"17031350100","350100"
"397",462,359,0,0,0,0,359,11,0,7,4,348,91,12,245,103,0,0,0,0,103,21,0,0,21,82,22,0,60,"17031350400","350400"
"398",414,38,0,0,0,0,38,38,0,0,38,0,0,0,0,376,150,107,0,43,226,13,0,0,13,213,59,0,154,"17031351000","351000"
"399",703,585,0,0,0,0,585,24,0,0,24,561,182,32,347,118,0,0,0,0,118,5,0,5,0,113,47,0,66,"17031351100","351100"
"400",342,258,0,0,0,0,258,0,0,0,0,258,54,39,165,84,17,6,6,5,67,0,0,0,0,67,0,0,67,"17031351400","351400"
"401",54,0,0,0,0,0,0,0,0,0,0,0,0,0,0,54,23,6,0,17,31,0,0,0,0,31,0,4,27,"17031351500","351500"
"402",528,311,17,0,0,17,294,9,9,0,0,285,41,34,210,217,15,0,0,15,202,0,0,0,0,202,10,0,192,"17031360200","360200"
"403",444,255,0,0,0,0,255,0,0,0,0,255,41,39,175,189,63,25,0,38,126,0,0,0,0,126,50,0,76,"17031380100","380100"
"404",307,58,0,0,0,0,58,0,0,0,0,58,42,0,16,249,239,52,0,187,10,0,0,0,0,10,0,0,10,"17031380200","380200"
"405",240,66,0,0,0,0,66,0,0,0,0,66,40,0,26,174,0,0,0,0,174,0,0,0,0,174,57,0,117,"17031380500","380500"
"406",244,60,0,0,0,0,60,0,0,0,0,60,6,0,54,184,89,35,10,44,95,0,0,0,0,95,33,5,57,"17031380700","380700"
"407",432,70,0,0,0,0,70,0,0,0,0,70,47,0,23,362,31,24,0,7,331,69,0,0,69,262,73,0,189,"17031381200","381200"
"408",476,160,0,0,0,0,160,74,30,0,44,86,0,30,56,316,125,9,16,100,191,13,0,0,13,178,46,0,132,"17031381400","381400"
"409",11,3,0,0,0,0,3,0,0,0,0,3,0,3,0,8,0,0,0,0,8,0,0,0,0,8,0,0,8,"17031381500","381500"
"410",0,0,0,0,0,0,0,0,0,0,0,0,0,0,0,0,0,0,0,0,0,0,0,0,0,0,0,0,0,"17031381700","381700"
"411",309,94,17,0,0,17,77,17,6,11,0,60,7,0,53,215,147,141,0,6,68,0,0,0,0,68,31,0,37,"17031381800","381800"
"412",273,70,0,0,0,0,70,0,0,0,0,70,24,0,46,203,43,0,13,30,160,0,0,0,0,160,11,0,149,"17031381900","381900"
"413",353,18,0,0,0,0,18,0,0,0,0,18,9,0,9,335,176,75,19,82,159,8,3,0,5,151,35,5,111,"17031390100","390100"
"414",431,258,0,0,0,0,258,0,0,0,0,258,13,0,245,173,141,92,0,49,32,0,0,0,0,32,19,0,13,"17031390200","390200"
"415",975,624,0,0,0,0,624,15,15,0,0,609,268,21,320,351,94,54,10,30,257,8,0,8,0,249,57,18,174,"17031390300","390300"
"416",746,407,0,0,0,0,407,0,0,0,0,407,108,91,208,339,75,41,16,18,264,19,0,0,19,245,21,0,224,"17031390400","390400"
"417",293,78,0,0,0,0,78,15,15,0,0,63,22,0,41,215,180,60,7,113,35,0,0,0,0,35,6,5,24,"17031390500","390500"
"418",431,69,0,0,0,0,69,56,28,0,28,13,13,0,0,362,277,131,9,137,85,18,0,0,18,67,10,0,57,"17031390600","390600"
"419",367,64,64,15,0,49,0,0,0,0,0,0,0,0,0,303,272,177,0,95,31,0,0,0,0,31,0,0,31,"17031390700","390700"
"420",413,162,0,0,0,0,162,29,15,0,14,133,47,10,76,251,63,7,15,41,188,15,6,0,9,173,0,0,173,"17031400300","400300"
"421",523,264,6,6,0,0,258,0,0,0,0,258,89,18,151,259,6,6,0,0,253,0,0,0,0,253,39,0,214,"17031400400","400400"
"422",883,681,122,30,12,80,559,47,0,0,47,512,130,54,328,202,51,0,0,51,151,34,1,0,33,117,48,0,69,"17031400500","400500"
"423",1186,771,0,0,0,0,771,57,20,0,37,714,230,73,411,415,154,44,0,110,261,13,0,13,0,248,52,20,176,"17031400800","400800"
"424",250,136,76,0,0,76,60,9,9,0,0,51,20,0,31,114,93,75,0,18,21,0,0,0,0,21,0,0,21,"17031410100","410100"
"425",119,44,20,20,0,0,24,0,0,0,0,24,0,0,24,75,70,65,0,5,5,0,0,0,0,5,0,0,5,"17031410200","410200"
"426",486,188,0,0,0,0,188,0,0,0,0,188,58,34,96,298,176,64,31,81,122,8,0,0,8,114,16,0,98,"17031410500","410500"
"427",432,12,12,0,0,12,0,0,0,0,0,0,0,0,0,420,369,139,25,205,51,14,0,0,14,37,0,0,37,"17031410600","410600"
"428",161,0,0,0,0,0,0,0,0,0,0,0,0,0,0,161,93,50,9,34,68,0,0,0,0,68,8,0,60,"17031410700","410700"
"429",575,127,10,10,0,0,117,0,0,0,0,117,72,0,45,448,261,121,0,140,187,73,38,0,35,114,65,0,49,"17031410800","410800"
"430",368,0,0,0,0,0,0,0,0,0,0,0,0,0,0,368,240,125,0,115,128,7,7,0,0,121,38,24,59,"17031410900","410900"
"431",183,35,0,0,0,0,35,0,0,0,0,35,35,0,0,148,139,39,0,100,9,0,0,0,0,9,0,0,9,"17031411000","411000"
"432",377,56,56,28,0,28,0,0,0,0,0,0,0,0,0,321,298,86,0,212,23,0,0,0,0,23,0,0,23,"17031411100","411100"
"433",342,78,78,19,0,59,0,0,0,0,0,0,0,0,0,264,242,39,0,203,22,0,0,0,0,22,0,0,22,"17031411200","411200"
"434",356,155,25,0,0,25,130,0,0,0,0,130,31,0,99,201,67,27,14,26,134,49,17,16,16,85,24,4,57,"17031420100","420100"
"435",428,72,0,0,0,0,72,0,0,0,0,72,25,0,47,356,216,106,10,100,140,0,0,0,0,140,27,0,113,"17031420200","420200"
"436",265,85,14,14,0,0,71,15,15,0,0,56,6,10,40,180,155,52,0,103,25,0,0,0,0,25,0,0,25,"17031420300","420300"
"437",221,161,92,27,0,65,69,0,0,0,0,69,31,0,38,60,22,22,0,0,38,0,0,0,0,38,0,0,38,"17031420400","420400"
"438",671,492,0,0,0,0,492,0,0,0,0,492,115,21,356,179,70,24,0,46,109,9,9,0,0,100,0,0,100,"17031420500","420500"
"439",484,370,0,0,0,0,370,0,0,0,0,370,80,31,259,114,9,0,0,9,105,14,7,0,7,91,41,0,50,"17031420600","420600"
"440",640,263,20,0,10,10,243,0,0,0,0,243,60,0,183,377,82,43,0,39,295,0,0,0,0,295,48,38,209,"17031420700","420700"
"441",646,351,135,0,0,135,216,0,0,0,0,216,62,0,154,295,79,29,3,47,216,12,0,0,12,204,45,40,119,"17031420800","420800"
"442",389,172,0,0,0,0,172,0,0,0,0,172,36,26,110,217,64,0,0,64,153,138,50,14,74,15,0,0,15,"17031421200","421200"
"443",1117,300,0,0,0,0,300,0,0,0,0,300,97,39,164,817,280,223,0,57,537,20,0,0,20,517,48,33,436,"17031430101","430101"
"444",568,138,47,47,0,0,91,0,0,0,0,91,47,0,44,430,236,113,28,95,194,50,25,25,0,144,48,0,96,"17031430102","430102"
"445",1270,845,0,0,0,0,845,0,0,0,0,845,261,44,540,425,155,0,0,155,270,62,62,0,0,208,57,49,102,"17031430200","430200"
"446",831,467,0,0,0,0,467,88,43,0,45,379,48,6,325,364,98,0,0,98,266,39,14,0,25,227,64,24,139,"17031430300","430300"
"447",788,349,84,14,23,47,265,0,0,0,0,265,60,20,185,439,75,10,6,59,364,165,25,0,140,199,69,9,121,"17031430400","430400"
"448",886,537,0,0,0,0,537,0,0,0,0,537,196,0,341,349,107,13,0,94,242,28,19,9,0,214,11,0,203,"17031430500","430500"
"449",488,152,0,0,0,0,152,33,27,0,6,119,29,0,90,336,56,0,0,56,280,30,25,0,5,250,87,0,163,"17031430600","430600"
"450",332,291,0,0,0,0,291,27,27,0,0,264,112,0,152,41,0,0,0,0,41,24,24,0,0,17,0,7,10,"17031430700","430700"
"451",376,200,4,0,0,4,196,0,0,0,0,196,56,0,140,176,69,44,0,25,107,11,11,0,0,96,39,22,35,"17031430800","430800"
"452",247,67,14,14,0,0,53,22,22,0,0,31,0,7,24,180,42,0,28,14,138,46,0,0,46,92,0,21,71,"17031430900","430900"
"453",528,16,6,0,0,6,10,0,0,0,0,10,10,0,0,512,261,26,14,221,251,75,19,0,56,176,29,7,140,"17031431200","431200"
"454",880,553,30,0,0,30,523,0,0,0,0,523,285,19,219,327,0,0,0,0,327,0,0,0,0,327,84,0,243,"17031431301","431301"
"455",823,233,0,0,0,0,233,0,0,0,0,233,84,10,139,590,106,0,35,71,484,0,0,0,0,484,80,45,359,"17031431302","431302"
"456",1245,346,72,32,0,40,274,40,0,0,40,234,84,0,150,899,237,56,0,181,662,95,25,0,70,567,136,21,410,"17031431400","431400"
"457",1138,679,18,0,0,18,661,51,0,14,37,610,265,11,334,459,195,0,0,195,264,50,0,20,30,214,35,0,179,"17031440101","440101"
"458",640,266,0,0,0,0,266,8,0,0,8,258,87,6,165,374,71,8,7,56,303,0,0,0,0,303,93,0,210,"17031440102","440102"
"459",1457,536,34,0,0,34,502,0,0,0,0,502,136,37,329,921,183,71,0,112,738,116,0,0,116,622,151,56,415,"17031440201","440201"
"460",683,201,26,0,0,26,175,0,0,0,0,175,50,0,125,482,143,52,0,91,339,42,0,0,42,297,100,22,175,"17031440202","440202"
"461",713,40,0,0,0,0,40,0,0,0,0,40,0,0,40,673,323,42,0,281,350,13,0,0,13,337,81,0,256,"17031440300","440300"
"462",450,129,48,0,0,48,81,19,0,0,19,62,29,0,33,321,139,37,0,102,182,46,0,0,46,136,18,0,118,"17031440600","440600"
"463",322,159,44,30,14,0,115,0,0,0,0,115,40,0,75,163,41,6,0,35,122,40,13,0,27,82,15,0,67,"17031440700","440700"
"464",592,341,24,0,0,24,317,0,0,0,0,317,111,0,206,251,23,0,0,23,228,0,0,0,0,228,43,15,170,"17031440800","440800"
"465",478,53,0,0,0,0,53,0,0,0,0,53,10,0,43,425,155,4,13,138,270,32,22,0,10,238,42,0,196,"17031440900","440900"
"466",616,213,27,0,0,27,186,23,0,0,23,163,49,10,104,403,227,92,0,135,176,10,0,0,10,166,31,8,127,"17031450300","450300"
"467",1031,506,51,0,11,40,455,38,0,0,38,417,153,29,235,525,298,44,13,241,227,61,0,0,61,166,72,0,94,"17031460100","460100"
"468",785,430,110,46,0,64,320,116,27,0,89,204,56,21,127,355,261,92,4,165,94,5,5,0,0,89,17,0,72,"17031460200","460200"
"469",739,317,52,0,0,52,265,0,0,0,0,265,124,38,103,422,198,31,0,167,224,67,0,0,67,157,62,0,95,"17031460301","460301"
"470",908,504,90,18,8,64,414,55,0,0,55,359,114,41,204,404,133,0,0,133,271,118,30,0,88,153,77,0,76,"17031460302","460302"
"471",671,165,0,0,0,0,165,0,0,0,0,165,12,11,142,506,243,78,26,139,263,29,0,0,29,234,119,0,115,"17031460400","460400"
"472",884,138,0,0,0,0,138,0,0,0,0,138,35,20,83,746,291,34,0,257,455,45,0,0,45,410,125,48,237,"17031460500","460500"
"473",269,167,0,0,0,0,167,0,0,0,0,167,48,23,96,102,22,0,0,22,80,0,0,0,0,80,27,0,53,"17031460600","460600"
"474",1306,990,252,106,23,123,738,175,44,29,102,563,152,29,382,316,202,55,0,147,114,0,0,0,0,114,19,0,95,"17031460700","460700"
"475",501,242,49,13,0,36,193,37,15,0,22,156,119,0,37,259,112,27,16,69,147,110,17,0,93,37,0,6,31,"17031461000","461000"
"476",767,550,147,0,0,147,403,0,0,0,0,403,78,0,325,217,53,19,0,34,164,14,8,0,6,150,30,12,108,"17031470100","470100"
"477",256,67,0,0,0,0,67,0,0,0,0,67,0,0,67,189,73,27,0,46,116,26,0,0,26,90,37,23,30,"17031480100","480100"
"478",211,73,43,15,0,28,30,0,0,0,0,30,10,0,20,138,56,16,0,40,82,0,0,0,0,82,0,0,82,"17031480200","480200"
"479",235,74,0,0,0,0,74,0,0,0,0,74,0,0,74,161,43,0,0,43,118,38,0,0,38,80,0,0,80,"17031480300","480300"
"480",1211,120,0,0,0,0,120,14,0,0,14,106,0,0,106,1091,427,87,94,246,664,0,0,0,0,664,151,53,460,"17031480400","480400"
"481",835,300,0,0,0,0,300,0,0,0,0,300,127,9,164,535,388,56,16,316,147,24,5,0,19,123,26,0,97,"17031480500","480500"
"482",508,130,39,0,0,39,91,0,0,0,0,91,29,0,62,378,309,37,54,218,69,0,0,0,0,69,2,0,67,"17031490300","490300"
"483",193,12,0,0,0,0,12,0,0,0,0,12,0,0,12,181,104,9,0,95,77,42,0,0,42,35,5,5,25,"17031490400","490400"
"484",479,41,11,11,0,0,30,23,0,0,23,7,0,0,7,438,265,69,15,181,173,10,0,0,10,163,6,0,157,"17031490500","490500"
"485",238,61,38,0,19,19,23,0,0,0,0,23,0,0,23,177,26,5,0,21,151,4,0,0,4,147,0,0,147,"17031490600","490600"
"486",634,293,10,0,0,10,283,39,0,0,39,244,25,0,219,341,154,9,5,140,187,44,6,0,38,143,38,11,94,"17031490700","490700"
"487",728,226,0,0,0,0,226,16,16,0,0,210,16,0,194,502,263,18,7,238,239,9,0,0,9,230,52,21,157,"17031490800","490800"
"488",895,429,105,37,34,34,324,60,28,0,32,264,81,0,183,466,148,29,11,108,318,7,7,0,0,311,146,0,165,"17031490901","490901"
"489",1124,127,0,0,0,0,127,0,0,0,0,127,50,0,77,997,655,82,141,432,342,50,32,18,0,292,61,0,231,"17031490902","490902"
"490",1682,1009,336,110,0,226,673,11,0,0,11,662,117,22,523,673,213,79,0,134,460,0,0,0,0,460,135,12,313,"17031491000","491000"
"491",1226,335,8,0,0,8,327,0,0,0,0,327,100,27,200,891,664,141,0,523,227,0,0,0,0,227,58,0,169,"17031491100","491100"
"492",606,148,49,17,0,32,99,56,14,42,0,43,12,0,31,458,105,42,0,63,353,0,0,0,0,353,106,0,247,"17031491200","491200"
"493",608,284,6,0,0,6,278,0,0,0,0,278,79,6,193,324,238,88,0,150,86,55,0,0,55,31,0,0,31,"17031491300","491300"
"494",560,294,0,0,0,0,294,56,0,0,56,238,116,0,122,266,120,0,0,120,146,24,24,0,0,122,61,0,61,"17031491400","491400"
"495",517,209,54,0,0,54,155,0,0,0,0,155,39,8,108,308,98,21,0,77,210,21,21,0,0,189,31,12,146,"17031500100","500100"
"496",640,373,42,22,0,20,331,0,0,0,0,331,135,36,160,267,35,5,0,30,232,92,59,0,33,140,63,23,54,"17031500200","500200"
"497",247,21,9,0,9,0,12,0,0,0,0,12,0,0,12,226,95,46,0,49,131,31,0,0,31,100,0,0,100,"17031500300","500300"
"498",1045,321,190,41,27,122,131,13,0,0,13,118,44,0,74,724,620,141,13,466,104,0,0,0,0,104,0,41,63,"17031510100","510100"
"499",642,269,23,8,0,15,246,14,0,0,14,232,52,0,180,373,50,0,0,50,323,0,0,0,0,323,58,0,265,"17031510200","510200"
"500",1377,669,59,19,8,32,610,14,0,0,14,596,174,0,422,708,518,130,0,388,190,0,0,0,0,190,12,0,178,"17031510300","510300"
"501",688,409,220,50,26,144,189,0,0,0,0,189,0,0,189,279,205,30,38,137,74,25,11,0,14,49,21,15,13,"17031520100","520100"
"502",1423,867,156,61,0,95,711,0,0,0,0,711,273,22,416,556,177,62,0,115,379,83,61,22,0,296,76,40,180,"17031520200","520200"
"503",2405,931,354,56,23,275,577,67,0,0,67,510,158,49,303,1474,1097,288,82,727,377,95,0,0,95,282,51,12,219,"17031520300","520300"
"504",1048,228,76,30,0,46,152,0,0,0,0,152,19,0,133,820,469,64,0,405,351,49,24,0,25,302,74,25,203,"17031520400","520400"
"505",936,159,44,15,0,29,115,0,0,0,0,115,49,0,66,777,637,125,12,500,140,11,0,0,11,129,24,0,105,"17031520500","520500"
"506",851,87,40,8,0,32,47,0,0,0,0,47,3,13,31,764,554,123,11,420,210,52,0,0,52,158,9,38,111,"17031520600","520600"
"507",680,389,49,21,11,17,340,93,0,24,69,247,93,0,154,291,162,98,0,64,129,116,9,0,107,13,13,0,0,"17031530100","530100"
"508",2063,1307,152,0,26,126,1155,45,22,23,0,1110,207,100,803,756,355,63,29,263,401,0,0,0,0,401,73,11,317,"17031530200","530200"
"509",1026,453,17,0,0,17,436,0,0,0,0,436,157,18,261,573,234,70,12,152,339,13,0,0,13,326,100,23,203,"17031530300","530300"
"510",502,160,0,0,0,0,160,22,11,0,11,138,52,9,77,342,76,7,0,69,266,50,8,9,33,216,50,0,166,"17031530400","530400"
"511",1658,1031,200,35,8,157,831,0,0,0,0,831,334,0,497,627,152,0,12,140,475,56,8,0,48,419,113,10,296,"17031530501","530501"
"512",288,86,0,0,0,0,86,0,0,0,0,86,20,0,66,202,162,10,0,152,40,0,0,0,0,40,9,10,21,"17031530502","530502"
"513",1161,546,43,0,13,30,503,30,0,0,30,473,74,9,390,615,349,75,0,274,266,27,0,0,27,239,16,0,223,"17031530503","530503"
"514",814,522,43,22,21,0,479,138,24,0,114,341,129,15,197,292,139,12,0,127,153,44,0,0,44,109,48,9,52,"17031530600","530600"
"515",1622,1191,104,0,0,104,1087,107,60,8,39,980,134,55,791,431,0,0,0,0,431,112,0,0,112,319,42,0,277,"17031540101","540101"
"516",1381,868,72,25,0,47,796,13,0,0,13,783,217,68,498,513,0,0,0,0,513,53,0,0,53,460,177,18,265,"17031540102","540102"
"517",1756,455,19,0,0,19,436,251,0,0,251,185,110,0,75,1301,796,283,0,513,505,106,30,0,76,399,151,52,196,"17031550100","550100"
"518",719,112,0,0,0,0,112,0,0,0,0,112,0,0,112,607,530,85,39,406,77,21,0,9,12,56,19,9,28,"17031550200","550200"
"519",278,76,0,0,0,0,76,0,0,0,0,76,17,0,59,202,140,7,0,133,62,62,24,0,38,0,0,0,0,"17031560100","560100"
"520",453,32,0,0,0,0,32,0,0,0,0,32,8,0,24,421,260,89,21,150,161,14,0,0,14,147,21,12,114,"17031560200","560200"
"521",819,74,0,0,0,0,74,59,12,0,47,15,0,0,15,745,649,172,83,394,96,53,38,0,15,43,0,0,43,"17031560300","560300"
"522",379,100,100,7,20,73,0,0,0,0,0,0,0,0,0,279,256,43,33,180,23,23,0,0,23,0,0,0,0,"17031560400","560400"
"523",778,180,79,0,0,79,101,0,0,0,0,101,27,0,74,598,428,98,32,298,170,127,127,0,0,43,16,18,9,"17031560700","560700"
"524",1116,13,0,0,0,0,13,0,0,0,0,13,13,0,0,1103,951,306,34,611,152,49,0,0,49,103,49,0,54,"17031560800","560800"
"525",1083,49,16,0,0,16,33,33,0,0,33,0,0,0,0,1034,971,175,104,692,63,35,0,0,35,28,0,8,20,"17031560900","560900"
"526",1059,267,87,14,0,73,180,0,0,0,0,180,0,0,180,792,648,181,11,456,144,45,0,0,45,99,0,0,99,"17031561000","561000"
"527",1281,24,24,0,0,24,0,0,0,0,0,0,0,0,0,1257,1137,365,35,737,120,17,8,9,0,103,25,29,49,"17031561100","561100"
"528",291,81,60,11,0,49,21,0,0,0,0,21,0,7,14,210,198,76,18,104,12,0,0,0,0,12,3,3,6,"17031570100","570100"
"529",421,18,18,12,0,6,0,0,0,0,0,0,0,0,0,403,220,33,9,178,183,40,40,0,0,143,52,0,91,"17031570200","570200"
"530",2257,620,241,41,21,179,379,59,26,0,33,320,69,17,234,1637,1191,451,80,660,446,173,102,0,71,273,32,26,215,"17031570300","570300"
"531",457,96,0,0,0,0,96,96,17,16,63,0,0,0,0,361,166,70,11,85,195,120,32,0,88,75,37,0,38,"17031570400","570400"
"532",641,141,87,28,0,59,54,23,23,0,0,31,0,0,31,500,340,159,0,181,160,88,72,0,16,72,18,0,54,"17031570500","570500"
"533",877,336,194,22,6,166,142,24,0,0,24,118,32,6,80,541,497,123,60,314,44,26,26,0,0,18,0,0,18,"17031580100","580100"
"534",952,395,50,15,0,35,345,92,26,0,66,253,31,30,192,557,337,110,16,211,220,16,0,0,16,204,3,42,159,"17031580200","580200"
"535",663,105,66,0,16,50,39,11,11,0,0,28,0,4,24,558,432,92,48,292,126,68,19,0,49,58,26,0,32,"17031580300","580300"
"536",1060,214,174,39,0,135,40,0,0,0,0,40,0,0,40,846,613,219,31,363,233,166,45,0,121,67,0,0,67,"17031580400","580400"
"537",988,333,135,62,0,73,198,77,77,0,0,121,54,0,67,655,433,124,0,309,222,196,116,0,80,26,17,0,9,"17031580501","580501"
"538",1305,198,153,8,8,137,45,0,0,0,0,45,45,0,0,1107,701,218,27,456,406,184,99,31,54,222,100,0,122,"17031580502","580502"
"539",2155,713,453,100,0,353,260,0,0,0,0,260,98,0,162,1442,1021,277,30,714,421,178,85,0,93,243,16,0,227,"17031580600","580600"
"540",2321,873,559,148,21,390,314,135,60,0,75,179,68,0,111,1448,987,167,77,743,461,111,15,0,96,350,42,0,308,"17031580700","580700"
"541",573,208,150,57,9,84,58,9,9,0,0,49,17,0,32,365,277,81,0,196,88,64,34,0,30,24,0,0,24,"17031580800","580800"
"542",454,115,90,37,19,34,25,8,0,0,8,17,0,0,17,339,237,77,4,156,102,65,65,0,0,37,0,21,16,"17031590500","590500"
"543",1315,192,81,39,8,34,111,39,0,0,39,72,0,0,72,1123,920,220,45,655,203,119,25,22,72,84,9,0,75,"17031590600","590600"
"544",998,204,109,14,14,81,95,0,0,0,0,95,31,0,64,794,575,194,31,350,219,113,61,0,52,106,41,5,60,"17031590700","590700"
"545",831,241,74,0,0,74,167,82,26,0,56,85,48,0,37,590,409,78,17,314,181,69,50,0,19,112,50,0,62,"17031600400","600400"
"546",512,296,65,0,16,49,231,20,0,0,20,211,0,0,211,216,111,28,0,83,105,10,10,0,0,95,5,0,90,"17031600600","600600"
"547",588,67,28,0,0,28,39,0,0,0,0,39,39,0,0,521,443,84,0,359,78,38,14,0,24,40,0,0,40,"17031600700","600700"
"548",697,133,13,13,0,0,120,13,0,0,13,107,20,13,74,564,441,137,0,304,123,11,11,0,0,112,8,16,88,"17031600900","600900"
"549",1694,920,346,141,33,172,574,205,161,0,44,369,139,40,190,774,501,141,10,350,273,93,10,25,58,180,35,36,109,"17031610300","610300"
"550",509,209,93,7,0,86,116,0,0,0,0,116,35,14,67,300,252,135,0,117,48,0,0,0,0,48,25,0,23,"17031610400","610400"
"551",406,130,77,38,0,39,53,0,0,0,0,53,0,0,53,276,231,84,0,147,45,22,0,22,0,23,0,0,23,"17031610800","610800"
"552",452,343,118,27,8,83,225,21,11,10,0,204,90,9,105,109,109,0,9,100,0,0,0,0,0,0,0,0,0,"17031611000","611000"
"553",874,517,147,43,13,91,370,62,31,0,31,308,130,0,178,357,160,31,9,120,197,49,26,0,23,148,50,7,91,"17031611100","611100"
"554",768,441,258,66,0,192,183,45,23,0,22,138,70,0,68,327,179,89,8,82,148,52,52,0,0,96,0,0,96,"17031611200","611200"
"555",1023,480,228,27,0,201,252,64,23,0,41,188,64,0,124,543,382,55,5,322,161,56,0,0,56,105,43,0,62,"17031611300","611300"
"556",1260,423,284,1,28,255,139,28,0,0,28,111,37,0,74,837,631,171,23,437,206,102,51,14,37,104,0,0,104,"17031611400","611400"
"557",928,192,150,16,5,129,42,0,0,0,0,42,11,0,31,736,490,126,30,334,246,156,59,0,97,90,17,0,73,"17031611500","611500"
"558",417,182,53,0,11,42,129,0,0,0,0,129,67,0,62,235,91,14,15,62,144,0,0,0,0,144,71,0,73,"17031611600","611600"
"559",455,275,0,0,0,0,275,13,0,0,13,262,108,14,140,180,102,26,0,76,78,4,4,0,0,74,0,14,60,"17031611700","611700"
"560",846,471,198,41,14,143,273,0,0,0,0,273,79,18,176,375,186,83,0,103,189,21,21,0,0,168,68,16,84,"17031611800","611800"
"561",764,421,10,5,0,5,411,58,16,0,42,353,99,5,249,343,97,36,0,61,246,28,19,0,9,218,49,8,161,"17031611900","611900"
"562",477,271,0,0,0,0,271,50,0,0,50,221,104,2,115,206,104,42,10,52,102,0,0,0,0,102,0,0,102,"17031612000","612000"
"563",294,111,59,0,0,59,52,0,0,0,0,52,35,0,17,183,10,0,0,10,173,0,0,0,0,173,18,11,144,"17031612100","612100"
"564",1408,415,231,72,0,159,184,0,0,0,0,184,96,30,58,993,723,178,8,537,270,12,0,6,6,258,56,12,190,"17031620100","620100"
"565",624,108,0,0,0,0,108,0,0,0,0,108,0,0,108,516,267,96,25,146,249,159,43,0,116,90,15,0,75,"17031620200","620200"
"566",1998,400,160,10,0,150,240,146,65,33,48,94,48,12,34,1598,1012,117,103,792,586,194,68,0,126,392,169,34,189,"17031620300","620300"
"567",1649,560,447,86,31,330,113,0,0,0,0,113,9,0,104,1089,1000,200,49,751,89,46,46,0,0,43,0,0,43,"17031620400","620400"
"568",288,166,0,0,0,0,166,74,22,10,42,92,0,0,92,122,82,24,0,58,40,0,0,0,0,40,5,4,31,"17031630100","630100"
"569",701,339,256,40,14,202,83,0,0,0,0,83,0,0,83,362,333,29,0,304,29,0,0,0,0,29,15,0,14,"17031630200","630200"
"570",1900,446,204,51,0,153,242,77,27,0,50,165,0,43,122,1454,1103,222,97,784,351,143,8,15,120,208,84,0,124,"17031630300","630300"
"571",2489,1001,684,147,20,517,317,119,41,19,59,198,53,0,145,1488,1037,265,9,763,451,167,53,19,95,284,98,0,186,"17031630400","630400"
"572",1822,539,442,170,14,258,97,22,8,0,14,75,19,0,56,1283,872,210,72,590,411,146,57,0,89,265,41,0,224,"17031630500","630500"
"573",2178,896,387,124,18,245,509,66,52,0,14,443,158,40,245,1282,915,257,85,573,367,199,38,20,141,168,9,66,93,"17031630800","630800"
"574",1354,492,463,91,49,323,29,29,29,0,0,0,0,0,0,862,696,168,29,499,166,66,0,20,46,100,73,0,27,"17031630900","630900"
"575",232,0,0,0,0,0,0,0,0,0,0,0,0,0,0,232,157,101,0,56,75,0,0,0,0,75,22,0,53,"17031640100","640100"
"576",1738,113,21,0,0,21,92,0,0,0,0,92,51,11,30,1625,917,184,9,724,708,578,190,0,388,130,16,15,99,"17031640300","640300"
"577",906,138,12,0,0,12,126,0,0,0,0,126,0,0,126,768,416,127,29,260,352,96,0,34,62,256,35,0,221,"17031640400","640400"
"578",595,58,0,0,0,0,58,0,0,0,0,58,27,15,16,537,520,110,12,398,17,11,0,0,11,6,6,0,0,"17031640500","640500"
"579",913,241,0,0,0,0,241,162,90,0,72,79,38,0,41,672,308,179,0,129,364,201,71,0,130,163,92,4,67,"17031640600","640600"
"580",887,106,12,0,6,6,94,16,0,0,16,78,15,0,63,781,557,150,51,356,224,81,81,0,0,143,45,6,92,"17031640700","640700"
"581",497,97,23,0,0,23,74,0,0,0,0,74,36,8,30,400,341,75,3,263,59,4,0,0,4,55,11,5,39,"17031640800","640800"
"582",1255,539,232,60,0,172,307,62,22,20,20,245,98,0,147,716,462,138,22,302,254,71,8,21,42,183,21,9,153,"17031650100","650100"
"583",2198,623,376,43,0,333,247,97,34,0,63,150,69,0,81,1575,1291,295,61,935,284,88,61,27,0,196,46,28,122,"17031650200","650200"
"584",1965,381,328,19,21,288,53,22,0,0,22,31,0,0,31,1584,1189,229,84,876,395,67,52,0,15,328,47,24,257,"17031650301","650301"
"585",1213,272,117,10,9,98,155,115,26,17,72,40,14,0,26,941,736,164,67,505,205,118,45,0,73,87,38,24,25,"17031650302","650302"
"586",2391,598,303,57,6,240,295,162,138,24,0,133,35,12,86,1793,1554,452,77,1025,239,51,0,0,51,188,66,11,111,"17031650400","650400"
"587",1040,248,234,23,0,211,14,0,0,0,0,14,0,0,14,792,596,141,18,437,196,0,0,0,0,196,24,0,172,"17031650500","650500"
"588",884,461,0,0,0,0,461,11,0,0,11,450,202,0,248,423,146,51,0,95,277,92,17,33,42,185,35,48,102,"17031660301","660301"
"589",2007,539,169,62,26,81,370,53,13,0,40,317,114,0,203,1468,958,191,71,696,510,128,53,43,32,382,60,24,298,"17031660302","660302"
"590",2099,886,487,115,0,372,399,69,18,0,51,330,123,0,207,1213,719,75,45,599,494,246,154,0,92,248,72,22,154,"17031660400","660400"
"591",1905,656,161,0,32,129,495,22,0,0,22,473,141,19,313,1249,924,219,47,658,325,32,19,0,13,293,101,12,180,"17031660500","660500"
"592",2024,1009,117,58,0,59,892,29,15,0,14,863,309,67,487,1015,422,145,0,277,593,20,0,0,20,573,155,10,408,"17031660600","660600"
"593",574,376,110,20,9,81,266,11,6,0,5,255,55,21,179,198,30,30,0,0,168,58,10,10,38,110,29,0,81,"17031660700","660700"
"594",2138,1018,268,55,19,194,750,353,181,65,107,397,51,25,321,1120,604,355,44,205,516,95,88,0,7,421,126,29,266,"17031660800","660800"
"595",1393,848,180,51,21,108,668,0,0,0,0,668,300,25,343,545,114,48,0,66,431,36,0,0,36,395,44,21,330,"17031660900","660900"
"596",1449,441,0,0,0,0,441,0,0,0,0,441,92,15,334,1008,454,174,26,254,554,33,0,0,33,521,240,9,272,"17031661000","661000"
"597",1619,557,245,49,5,191,312,17,9,0,8,295,116,16,163,1062,496,81,13,402,566,174,22,10,142,392,96,47,249,"17031661100","661100"
"598",650,470,6,0,0,6,464,51,18,0,33,413,162,26,225,180,5,0,5,0,175,104,23,0,81,71,8,0,63,"17031670100","670100"
"599",365,162,0,0,0,0,162,0,0,0,0,162,54,10,98,203,73,11,0,62,130,9,0,0,9,121,15,11,95,"17031670200","670200"
"600",417,269,0,0,0,0,269,0,0,0,0,269,100,13,156,148,18,0,0,18,130,0,0,0,0,130,41,2,87,"17031670300","670300"
"601",400,344,202,43,39,120,142,40,11,0,29,102,7,0,95,56,20,15,0,5,36,0,0,0,0,36,4,0,32,"17031670400","670400"
"602",317,285,56,0,0,56,229,0,0,0,0,229,46,0,183,32,21,0,0,21,11,0,0,0,0,11,0,0,11,"17031670500","670500"
"603",331,242,65,29,0,36,177,27,27,0,0,150,39,0,111,89,15,8,0,7,74,21,15,0,6,53,0,0,53,"17031670600","670600"
"604",398,226,0,0,0,0,226,0,0,0,0,226,54,21,151,172,10,10,0,0,162,0,0,0,0,162,20,12,130,"17031670700","670700"
"605",366,207,51,0,0,51,156,18,13,0,5,138,45,19,74,159,101,46,0,55,58,0,0,0,0,58,10,0,48,"17031670800","670800"
"606",303,83,0,0,0,0,83,0,0,0,0,83,0,0,83,220,130,12,0,118,90,22,22,0,0,68,0,0,68,"17031670900","670900"
"607",591,463,69,0,0,69,394,6,0,0,6,388,127,0,261,128,56,26,0,30,72,0,0,0,0,72,25,4,43,"17031671100","671100"
"608",267,116,0,0,0,0,116,0,0,0,0,116,22,11,83,151,66,23,0,43,85,50,26,0,24,35,0,0,35,"17031671200","671200"
"609",587,372,32,0,0,32,340,0,0,0,0,340,77,27,236,215,76,8,0,68,139,0,0,0,0,139,27,13,99,"17031671300","671300"
"610",302,55,0,0,0,0,55,18,0,0,18,37,6,0,31,247,67,5,0,62,180,0,0,0,0,180,60,16,104,"17031671400","671400"
"611",1037,487,47,0,0,47,440,10,10,0,0,430,180,19,231,550,90,26,21,43,460,0,0,0,0,460,107,0,353,"17031671500","671500"
"612",568,251,0,0,0,0,251,34,34,0,0,217,67,19,131,317,55,0,0,55,262,72,15,14,43,190,35,0,155,"17031671600","671600"
"613",211,86,0,0,0,0,86,18,0,18,0,68,11,0,57,125,0,0,0,0,125,11,0,0,11,114,11,0,103,"17031671800","671800"
"614",333,67,0,0,0,0,67,0,0,0,0,67,12,0,55,266,61,12,0,49,205,0,0,0,0,205,29,5,171,"17031671900","671900"
"615",1008,250,81,0,0,81,169,0,0,0,0,169,75,0,94,758,503,230,53,220,255,53,39,0,14,202,19,21,162,"17031672000","672000"
"616",372,242,88,41,18,29,154,13,13,0,0,141,50,0,91,130,0,0,0,0,130,0,0,0,0,130,49,12,69,"17031680500","680500"
"617",536,328,17,6,0,11,311,0,0,0,0,311,111,29,171,208,43,15,0,28,165,0,0,0,0,165,29,0,136,"17031680600","680600"
"618",837,528,79,30,6,43,449,43,43,0,0,406,70,30,306,309,181,75,0,106,128,21,0,0,21,107,47,0,60,"17031680900","680900"
"619",987,697,27,27,0,0,670,39,39,0,0,631,176,6,449,290,100,9,15,76,190,9,0,0,9,181,96,0,85,"17031681000","681000"
"620",1022,628,13,0,0,13,615,18,0,0,18,597,226,26,345,394,74,26,0,48,320,0,0,0,0,320,56,24,240,"17031681100","681100"
"621",890,597,16,16,0,0,581,15,15,0,0,566,98,41,427,293,98,19,14,65,195,41,0,0,41,154,18,10,126,"17031681200","681200"
"622",774,416,0,0,0,0,416,10,0,0,10,406,143,22,241,358,119,0,0,119,239,30,10,10,10,209,53,42,114,"17031681300","681300"
"623",906,638,103,36,0,67,535,79,27,26,26,456,101,13,342,268,0,0,0,0,268,28,0,0,28,240,33,9,198,"17031681400","681400"
"624",548,309,0,0,0,0,309,78,78,0,0,231,76,26,129,239,81,36,0,45,158,71,23,0,48,87,0,30,57,"17031690300","690300"
"625",887,550,0,0,0,0,550,12,0,0,12,538,22,37,479,337,24,14,0,10,313,35,8,0,27,278,45,22,211,"17031690400","690400"
"626",304,189,42,42,0,0,147,0,0,0,0,147,103,5,39,115,17,0,0,17,98,0,0,0,0,98,14,0,84,"17031690500","690500"
"627",1174,598,0,0,0,0,598,100,0,0,100,498,86,0,412,576,62,0,0,62,514,24,0,24,0,490,144,0,346,"17031690900","690900"
"628",665,265,0,0,0,0,265,0,0,0,0,265,56,0,209,400,116,22,0,94,284,71,0,0,71,213,49,7,157,"17031691000","691000"
"629",890,548,59,20,20,19,489,19,0,0,19,470,226,0,244,342,95,0,0,95,247,20,0,0,20,227,42,0,185,"17031691100","691100"
"630",859,619,84,57,27,0,535,46,0,0,46,489,171,32,286,240,82,21,0,61,158,11,0,0,11,147,0,0,147,"17031691200","691200"
"631",696,50,36,0,0,36,14,0,0,0,0,14,14,0,0,646,286,187,0,99,360,34,18,0,16,326,86,21,219,"17031691300","691300"
"632",733,233,19,0,0,19,214,0,0,0,0,214,41,0,173,500,149,0,14,135,351,38,0,0,38,313,141,18,154,"17031691400","691400"
"633",682,409,0,0,0,0,409,162,58,0,104,247,77,0,170,273,21,0,0,21,252,15,8,0,7,237,60,0,177,"17031691500","691500"
"634",861,144,106,0,53,53,38,0,0,0,0,38,0,0,38,717,345,59,0,286,372,61,4,44,13,311,7,96,208,"17031700100","700100"
"635",2272,583,84,12,0,72,499,32,0,0,32,467,150,0,317,1689,1323,375,35,913,366,126,36,0,90,240,64,0,176,"17031700200","700200"
"636",2094,594,333,18,0,315,261,91,47,0,44,170,49,0,121,1500,1163,337,66,760,337,193,51,69,73,144,19,0,125,"17031700301","700301"
"637",1366,316,124,0,0,124,192,18,18,0,0,174,19,0,155,1050,755,300,24,431,295,10,0,0,10,285,50,0,235,"17031700302","700302"
"638",1455,171,150,16,0,134,21,0,0,0,0,21,0,0,21,1284,909,195,0,714,375,64,8,0,56,311,148,0,163,"17031700401","700401"
"639",1018,229,140,48,0,92,89,0,0,0,0,89,21,0,68,789,566,111,28,427,223,54,0,27,27,169,44,35,90,"17031700402","700402"
"640",1440,118,0,0,0,0,118,0,0,0,0,118,31,0,87,1322,608,175,28,405,714,149,0,75,74,565,73,12,480,"17031700501","700501"
"641",658,6,6,6,0,0,0,0,0,0,0,0,0,0,0,652,493,113,22,358,159,0,0,0,0,159,46,0,113,"17031700502","700502"
"642",417,305,13,7,6,0,292,0,0,0,0,292,137,0,155,112,22,14,0,8,90,21,7,0,14,69,3,0,66,"17031710100","710100"
"643",2373,1537,0,0,0,0,1537,273,208,0,65,1264,430,48,786,836,61,34,27,0,775,69,18,0,51,706,203,72,431,"17031710200","710200"
"644",351,142,57,0,19,38,85,0,0,0,0,85,10,0,75,209,64,11,0,53,145,0,0,0,0,145,17,0,128,"17031710300","710300"
"645",925,481,9,0,0,9,472,44,0,0,44,428,89,43,296,444,301,44,15,242,143,69,46,0,23,74,12,0,62,"17031710400","710400"
"646",1207,531,101,0,0,101,430,19,0,0,19,411,132,41,238,676,238,22,25,191,438,46,0,0,46,392,77,17,298,"17031710500","710500"
"647",548,397,19,0,0,19,378,67,10,19,38,311,104,0,207,151,23,23,0,0,128,32,0,0,32,96,12,13,71,"17031710600","710600"
"648",564,344,41,0,0,41,303,0,0,0,0,303,81,0,222,220,143,11,0,132,77,0,0,0,0,77,0,0,77,"17031710700","710700"
"649",946,16,0,0,0,0,16,0,0,0,0,16,16,0,0,930,123,55,0,68,807,73,0,0,73,734,370,13,351,"17031710800","710800"
"650",786,556,24,0,0,24,532,50,12,0,38,482,94,31,357,230,195,28,18,149,35,0,0,0,0,35,8,0,27,"17031710900","710900"
"651",810,349,56,15,0,41,293,0,0,0,0,293,79,15,199,461,151,48,0,103,310,9,0,0,9,301,81,11,209,"17031711000","711000"
"652",934,464,118,12,12,94,346,0,0,0,0,346,67,10,269,470,229,0,0,229,241,16,0,0,16,225,57,13,155,"17031711100","711100"
"653",1127,386,0,0,0,0,386,0,0,0,0,386,72,0,314,741,340,53,16,271,401,9,0,0,9,392,86,41,265,"17031711200","711200"
"654",373,158,0,0,0,0,158,0,0,0,0,158,23,14,121,215,111,7,0,104,104,22,7,0,15,82,26,0,56,"17031711300","711300"
"655",400,180,9,0,0,9,171,18,0,0,18,153,54,5,94,220,152,27,12,113,68,11,7,0,4,57,0,14,43,"17031711400","711400"
"656",489,107,67,30,0,37,40,0,0,0,0,40,24,8,8,382,121,18,0,103,261,27,0,0,27,234,75,4,155,"17031711500","711500"
"657",1089,0,0,0,0,0,0,0,0,0,0,0,0,0,0,1089,1028,516,44,468,61,54,0,10,44,7,0,0,7,"17031720100","720100"
"658",1221,154,0,0,0,0,154,0,0,0,0,154,53,0,101,1067,857,162,112,583,210,41,0,0,41,169,39,0,130,"17031720200","720200"
"659",1166,0,0,0,0,0,0,0,0,0,0,0,0,0,0,1166,1013,110,76,827,153,84,0,31,53,69,10,10,49,"17031720300","720300"
"660",572,0,0,0,0,0,0,0,0,0,0,0,0,0,0,572,526,97,29,400,46,30,0,0,30,16,0,0,16,"17031720400","720400"
"661",559,0,0,0,0,0,0,0,0,0,0,0,0,0,0,559,492,84,32,376,67,52,0,0,52,15,0,0,15,"17031720500","720500"
"662",540,0,0,0,0,0,0,0,0,0,0,0,0,0,0,540,510,143,23,344,30,30,10,0,20,0,0,0,0,"17031720600","720600"
"663",701,0,0,0,0,0,0,0,0,0,0,0,0,0,0,701,427,161,22,244,274,0,0,0,0,274,85,0,189,"17031720700","720700"
"664",467,136,58,0,0,58,78,5,0,0,5,73,4,0,69,331,166,25,14,127,165,12,0,0,12,153,23,13,117,"17031730100","730100"
"665",1245,449,0,0,0,0,449,37,37,0,0,412,145,11,256,796,154,38,19,97,642,11,0,0,11,631,144,101,386,"17031730201","730201"
"666",645,253,190,0,0,190,63,53,0,26,27,10,5,0,5,392,103,11,0,92,289,11,0,0,11,278,28,0,250,"17031730202","730202"
"667",269,100,0,0,0,0,100,0,0,0,0,100,16,0,84,169,117,23,0,94,52,9,0,0,9,43,12,9,22,"17031730300","730300"
"668",482,109,24,0,0,24,85,56,8,0,48,29,0,0,29,373,119,38,6,75,254,32,0,0,32,222,7,0,215,"17031730400","730400"
"669",826,149,17,17,0,0,132,2,0,0,2,130,0,0,130,677,139,56,0,83,538,0,0,0,0,538,106,0,432,"17031730500","730500"
"670",495,102,76,0,26,50,26,0,0,0,0,26,11,0,15,393,160,54,14,92,233,31,0,0,31,202,13,31,158,"17031730600","730600"
"671",581,211,56,0,0,56,155,26,26,0,0,129,7,0,122,370,83,25,8,50,287,48,0,0,48,239,134,0,105,"17031730700","730700"
"672",684,8,0,0,0,0,8,0,0,0,0,8,0,0,8,676,621,264,33,324,55,26,0,0,26,29,10,0,19,"17031740100","740100"
"673",1525,0,0,0,0,0,0,0,0,0,0,0,0,0,0,1525,1322,349,39,934,203,19,0,0,19,184,30,0,154,"17031740200","740200"
"674",1313,0,0,0,0,0,0,0,0,0,0,0,0,0,0,1313,1181,369,73,739,132,0,0,0,0,132,39,7,86,"17031740300","740300"
"675",1318,22,0,0,0,0,22,0,0,0,0,22,10,0,12,1296,993,349,34,610,303,170,11,0,159,133,19,0,114,"17031740400","740400"
"676",1089,435,24,24,0,0,411,21,0,0,21,390,114,11,265,654,227,10,44,173,427,64,0,0,64,363,61,10,292,"17031750100","750100"
"677",642,32,10,0,0,10,22,0,0,0,0,22,6,0,16,610,534,44,47,443,76,8,0,0,8,68,24,0,44,"17031750200","750200"
"678",902,0,0,0,0,0,0,0,0,0,0,0,0,0,0,902,659,109,28,522,243,74,69,0,5,169,8,0,161,"17031750300","750300"
"679",795,25,0,0,0,0,25,0,0,0,0,25,17,0,8,770,592,248,20,324,178,30,30,0,0,148,41,23,84,"17031750400","750400"
"680",1424,286,159,42,0,117,127,0,0,0,0,127,0,0,127,1138,664,187,0,477,474,31,16,0,15,443,24,0,419,"17031750500","750500"
"681",817,415,46,0,0,46,369,67,23,0,44,302,28,11,263,402,186,75,33,78,216,19,0,0,19,197,92,0,105,"17031750600","750600"
"682",864,440,385,179,0,206,55,0,0,0,0,55,55,0,0,424,298,263,12,23,126,0,0,0,0,126,12,0,114,"17031760801","760801"
"683",231,29,29,10,0,19,0,0,0,0,0,0,0,0,0,202,202,19,7,176,0,0,0,0,0,0,0,0,0,"17031760802","760802"
"684",1629,598,548,275,46,227,50,50,33,0,17,0,0,0,0,1031,789,441,7,341,242,129,0,43,86,113,0,0,113,"17031760803","760803"
"685",1184,104,54,0,0,54,50,0,0,0,0,50,0,0,50,1080,944,260,13,671,136,37,0,0,37,99,31,0,68,"17031770201","770201"
"686",983,25,25,0,0,25,0,0,0,0,0,0,0,0,0,958,729,111,18,600,229,42,0,42,0,187,0,0,187,"17031770202","770202"
"687",1426,169,39,0,0,39,130,0,0,0,0,130,14,0,116,1257,1093,307,62,724,164,0,0,0,0,164,0,0,164,"17031770300","770300"
"688",1002,175,31,31,0,0,144,23,23,0,0,121,72,13,36,827,662,123,69,470,165,86,25,0,61,79,13,0,66,"17031770400","770400"
"689",1167,351,272,130,16,126,79,20,0,20,0,59,0,19,40,816,457,138,0,319,359,162,36,28,98,197,53,0,144,"17031770500","770500"
"690",527,0,0,0,0,0,0,0,0,0,0,0,0,0,0,527,490,100,19,371,37,10,10,0,0,27,0,27,0,"17031770601","770601"
"691",1150,337,337,138,11,188,0,0,0,0,0,0,0,0,0,813,721,129,27,565,92,36,5,0,31,56,16,16,24,"17031770602","770602"
"692",550,115,91,38,15,38,24,0,0,0,0,24,14,0,10,435,297,77,11,209,138,29,6,4,19,109,15,23,71,"17031770700","770700"
"693",1339,324,178,114,0,64,146,0,0,0,0,146,26,0,120,1015,785,261,28,496,230,15,0,0,15,215,66,14,135,"17031770800","770800"
"694",908,153,135,57,0,78,18,18,0,0,18,0,0,0,0,755,700,190,6,504,55,25,25,0,0,30,10,0,20,"17031770901","770901"
"695",457,46,10,0,0,10,36,18,0,0,18,18,18,0,0,411,321,78,31,212,90,0,0,0,0,90,18,13,59,"17031770902","770902"
"696",760,13,0,0,0,0,13,0,0,0,0,13,0,0,13,747,719,108,17,594,28,0,0,0,0,28,0,0,28,"17031800100","800100"
"697",2007,33,33,0,0,33,0,0,0,0,0,0,0,0,0,1974,1709,481,62,1166,265,46,0,0,46,219,0,71,148,"17031800200","800200"
"698",1049,0,0,0,0,0,0,0,0,0,0,0,0,0,0,1049,975,181,37,757,74,26,0,0,26,48,17,0,31,"17031800300","800300"
"699",1389,25,15,15,0,0,10,10,0,0,10,0,0,0,0,1364,1280,350,56,874,84,0,0,0,0,84,0,0,84,"17031800400","800400"
"700",1753,72,49,17,0,32,23,0,0,0,0,23,0,0,23,1681,1559,342,101,1116,122,4,0,0,4,118,0,0,118,"17031800500","800500"
"701",976,17,0,0,0,0,17,0,0,0,0,17,4,4,9,959,951,92,46,813,8,0,0,0,0,8,0,0,8,"17031800600","800600"
"702",1573,19,19,0,0,19,0,0,0,0,0,0,0,0,0,1554,1406,277,108,1021,148,14,0,0,14,134,10,0,124,"17031800700","800700"
"703",300,27,27,0,9,18,0,0,0,0,0,0,0,0,0,273,235,13,0,222,38,14,0,0,14,24,0,0,24,"17031800800","800800"
"704",1128,71,71,0,0,71,0,0,0,0,0,0,0,0,0,1057,794,150,58,586,263,39,10,0,29,224,23,4,197,"17031800900","800900"
"705",1344,45,15,0,0,15,30,7,7,0,0,23,0,0,23,1299,1163,253,79,831,136,52,0,0,52,84,19,0,65,"17031801000","801000"
"706",1645,0,0,0,0,0,0,0,0,0,0,0,0,0,0,1645,1523,414,81,1028,122,70,0,0,70,52,22,0,30,"17031801100","801100"
"707",842,0,0,0,0,0,0,0,0,0,0,0,0,0,0,842,781,107,14,660,61,10,0,0,10,51,0,0,51,"17031801200","801200"
"708",1442,26,26,0,0,26,0,0,0,0,0,0,0,0,0,1416,1138,220,106,812,278,30,0,0,30,248,0,31,217,"17031801300","801300"
"709",876,25,25,0,0,25,0,0,0,0,0,0,0,0,0,851,767,193,51,523,84,58,0,0,58,26,0,0,26,"17031801400","801400"
"710",1394,40,40,0,17,23,0,0,0,0,0,0,0,0,0,1354,1183,191,54,938,171,0,0,0,0,171,0,0,171,"17031801500","801500"
"711",916,6,6,6,0,0,0,0,0,0,0,0,0,0,0,910,740,176,88,476,170,23,0,0,23,147,27,0,120,"17031801601","801601"
"712",974,259,124,27,32,65,135,0,0,0,0,135,73,31,31,715,614,183,36,395,101,9,0,0,9,92,0,0,92,"17031801603","801603"
"713",1144,40,33,0,0,33,7,0,0,0,0,7,0,0,7,1104,1023,119,115,789,81,0,0,0,0,81,27,0,54,"17031801605","801605"
"714",1229,85,38,0,0,38,47,31,0,0,31,16,0,0,16,1144,1133,174,55,904,11,11,0,0,11,0,0,0,0,"17031801606","801606"
"715",1011,54,9,0,0,9,45,0,0,0,0,45,0,0,45,957,807,217,11,579,150,21,0,0,21,129,0,0,129,"17031801607","801607"
"716",1141,49,23,0,0,23,26,26,0,0,26,0,0,0,0,1092,1062,259,30,773,30,13,13,0,0,17,0,0,17,"17031801608","801608"
"717",915,0,0,0,0,0,0,0,0,0,0,0,0,0,0,915,831,168,51,612,84,32,0,0,32,52,13,0,39,"17031801701","801701"
"718",1529,111,52,10,0,42,59,0,0,0,0,59,0,0,59,1418,1320,417,94,809,98,20,0,0,20,78,0,0,78,"17031801702","801702"
"719",1352,43,13,0,0,13,30,11,0,0,11,19,0,0,19,1309,1080,189,44,847,229,30,0,15,15,199,0,0,199,"17031801800","801800"
"720",645,3,3,0,0,3,0,0,0,0,0,0,0,0,0,642,607,242,12,353,35,35,9,0,26,0,0,0,0,"17031801901","801901"
"721",876,21,21,21,0,0,0,0,0,0,0,0,0,0,0,855,820,106,52,662,35,14,0,0,14,21,0,0,21,"17031801902","801902"
"722",1404,97,97,43,14,40,0,0,0,0,0,0,0,0,0,1307,1183,242,93,848,124,28,0,14,14,96,8,0,88,"17031802002","802002"
"723",735,155,155,45,0,110,0,0,0,0,0,0,0,0,0,580,475,125,40,310,105,38,22,0,16,67,0,0,67,"17031802003","802003"
"724",1092,231,206,57,0,149,25,0,0,0,0,25,25,0,0,861,605,188,49,368,256,154,0,0,154,102,38,9,55,"17031802004","802004"
"725",1046,9,9,9,0,0,0,0,0,0,0,0,0,0,0,1037,911,140,79,692,126,34,0,0,34,92,17,0,75,"17031802100","802100"
"726",1070,10,0,0,0,0,10,0,0,0,0,10,0,0,10,1060,874,186,36,652,186,42,0,0,42,144,0,0,144,"17031802200","802200"
"727",1444,38,0,0,0,0,38,38,0,0,38,0,0,0,0,1406,1198,286,32,880,208,113,13,0,100,95,27,12,56,"17031802300","802300"
"728",1179,410,410,172,131,107,0,0,0,0,0,0,0,0,0,769,623,284,81,258,146,38,0,0,38,108,10,0,98,"17031802402","802402"
"729",119,0,0,0,0,0,0,0,0,0,0,0,0,0,0,119,96,38,0,58,23,0,0,0,0,23,0,0,23,"17031802403","802403"
"730",1695,139,26,0,13,13,113,0,0,0,0,113,55,0,58,1556,1214,405,181,628,342,66,36,15,15,276,17,41,218,"17031802404","802404"
"731",864,100,0,0,0,0,100,0,0,0,0,100,0,0,100,764,733,268,53,412,31,10,0,0,10,21,0,0,21,"17031802503","802503"
"732",1531,82,82,29,0,53,0,0,0,0,0,0,0,0,0,1449,1067,137,60,870,382,63,24,0,39,319,59,0,260,"17031802504","802504"
"733",1965,373,116,39,0,77,257,0,0,0,0,257,0,23,234,1592,1341,333,154,854,251,142,76,0,66,109,15,0,94,"17031802505","802505"
"734",711,199,131,68,0,63,68,0,0,0,0,68,0,34,34,512,419,181,0,238,93,63,45,0,18,30,0,0,30,"17031802506","802506"
"735",1218,0,0,0,0,0,0,0,0,0,0,0,0,0,0,1218,1105,423,41,641,113,33,21,0,12,80,0,0,80,"17031802605","802605"
"736",332,0,0,0,0,0,0,0,0,0,0,0,0,0,0,332,303,36,5,262,29,13,4,0,9,16,16,0,0,"17031802607","802607"
"737",1150,35,0,0,0,0,35,0,0,0,0,35,0,0,35,1115,994,421,84,489,121,13,0,0,13,108,0,0,108,"17031802608","802608"
"738",1504,410,282,115,0,167,128,11,0,0,11,117,29,22,66,1094,835,422,30,383,259,112,57,0,55,147,0,0,147,"17031802609","802609"
"739",235,0,0,0,0,0,0,0,0,0,0,0,0,0,0,235,235,58,0,177,0,0,0,0,0,0,0,0,0,"17031802610","802610"
"740",2061,158,158,24,11,123,0,0,0,0,0,0,0,0,0,1903,1775,509,55,1211,128,128,5,59,64,0,0,0,0,"17031802701","802701"
"741",923,16,11,11,0,0,5,0,0,0,0,5,0,0,5,907,856,226,71,559,51,8,0,0,8,43,0,0,43,"17031802702","802702"
"742",1308,116,116,43,0,73,0,0,0,0,0,0,0,0,0,1192,874,205,30,639,318,15,7,0,8,303,29,26,248,"17031802801","802801"
"743",1462,37,0,0,0,0,37,0,0,0,0,37,0,0,37,1425,1279,421,54,804,146,29,0,0,29,117,8,0,109,"17031802802","802802"
"744",1392,29,13,0,0,13,16,0,0,0,0,16,0,0,16,1363,1280,439,64,777,83,31,16,0,15,52,0,0,52,"17031802900","802900"
"745",530,63,33,33,0,0,30,0,0,0,0,30,11,9,10,467,462,57,27,378,5,5,0,0,5,0,0,0,0,"17031803005","803005"
"746",1131,146,146,93,0,53,0,0,0,0,0,0,0,0,0,985,958,167,46,745,27,5,0,0,5,22,0,0,22,"17031803007","803007"
"747",1147,34,34,0,0,34,0,0,0,0,0,0,0,0,0,1113,982,235,76,671,131,35,0,10,25,96,26,0,70,"17031803008","803008"
"748",1131,37,31,0,0,31,6,0,0,0,0,6,0,0,6,1094,1020,275,67,678,74,0,0,0,0,74,9,8,57,"17031803010","803010"
"749",461,10,10,0,0,10,0,0,0,0,0,0,0,0,0,451,389,115,7,267,62,0,0,0,0,62,0,0,62,"17031803012","803012"
"750",1080,14,4,2,1,1,10,0,0,0,0,10,0,0,10,1066,901,343,99,459,165,66,66,0,0,99,0,0,99,"17031803013","803013"
"751",692,11,11,11,0,0,0,0,0,0,0,0,0,0,0,681,574,213,20,341,107,72,0,0,72,35,0,7,28,"17031803014","803014"
"752",861,172,54,54,0,0,118,0,0,0,0,118,0,0,118,689,519,81,32,406,170,33,18,0,15,137,0,0,137,"17031803015","803015"
"753",573,22,22,0,0,22,0,0,0,0,0,0,0,0,0,551,513,213,22,278,38,0,0,0,0,38,0,0,38,"17031803016","803016"
"754",1078,11,0,0,0,0,11,0,0,0,0,11,0,0,11,1067,1011,432,0,579,56,0,0,0,0,56,0,0,56,"17031803017","803017"
"755",893,24,0,0,0,0,24,0,0,0,0,24,14,0,10,869,804,81,32,691,65,10,0,0,10,55,0,14,41,"17031803100","803100"
"756",1228,37,0,0,0,0,37,0,0,0,0,37,0,18,19,1191,1103,224,152,727,88,13,0,0,13,75,0,0,75,"17031803200","803200"
"757",1295,0,0,0,0,0,0,0,0,0,0,0,0,0,0,1295,1087,370,15,702,208,83,0,0,83,125,40,0,85,"17031803300","803300"
"758",1561,122,122,22,0,100,0,0,0,0,0,0,0,0,0,1439,1265,258,58,949,174,61,19,0,42,113,0,0,113,"17031803400","803400"
"759",1622,0,0,0,0,0,0,0,0,0,0,0,0,0,0,1622,1333,357,57,919,289,146,17,0,129,143,0,0,143,"17031803500","803500"
"760",1579,0,0,0,0,0,0,0,0,0,0,0,0,0,0,1579,1378,296,16,1066,201,69,0,0,69,132,0,0,132,"17031803603","803603"
"761",927,69,18,0,0,18,51,0,0,0,0,51,0,0,51,858,717,195,15,507,141,0,0,0,0,141,14,0,127,"17031803604","803604"
"762",1839,237,148,50,18,80,89,0,0,0,0,89,0,0,89,1602,1493,381,63,1049,109,24,11,0,13,85,0,0,85,"17031803605","803605"
"763",3511,2020,983,364,32,587,1037,214,83,0,131,823,221,11,591,1491,792,213,34,545,699,323,188,25,110,376,54,45,277,"17031803606","803606"
"764",1070,16,0,0,0,0,16,3,1,0,2,13,0,0,13,1054,1002,340,20,642,52,5,0,0,5,47,0,0,47,"17031803607","803607"
"765",1847,102,16,0,16,0,86,86,0,0,86,0,0,0,0,1745,997,231,36,730,748,244,162,0,82,504,216,0,288,"17031803608","803608"
"766",1827,231,82,17,0,65,149,0,0,0,0,149,57,0,92,1596,1130,447,107,576,466,143,102,0,41,323,78,29,216,"17031803610","803610"
"767",1504,281,130,13,0,117,151,39,39,0,0,112,87,0,25,1223,832,267,85,480,391,170,91,15,64,221,36,0,185,"17031803611","803611"
"768",862,131,0,0,0,0,131,44,0,0,44,87,0,0,87,731,457,124,49,284,274,78,39,0,39,196,67,22,107,"17031803612","803612"
"769",465,26,26,26,0,0,0,0,0,0,0,0,0,0,0,439,382,228,19,135,57,37,28,9,0,20,0,0,20,"17031803701","803701"
"770",1274,31,0,0,0,0,31,31,0,0,31,0,0,0,0,1243,964,347,35,582,279,126,86,0,40,153,0,0,153,"17031803702","803702"
"771",1375,142,102,15,0,87,40,8,8,0,0,32,0,0,32,1233,1004,288,66,650,229,54,0,0,54,175,63,12,100,"17031803800","803800"
"772",444,9,0,0,0,0,9,0,0,0,0,9,9,0,0,435,368,130,49,189,67,6,0,0,6,61,14,0,47,"17031803901","803901"
"773",935,69,22,0,22,0,47,21,21,0,0,26,0,0,26,866,678,114,84,480,188,139,94,0,45,49,8,0,41,"17031803902","803902"
"774",817,43,8,4,4,0,35,0,0,0,0,35,0,0,35,774,696,256,14,426,78,14,0,0,14,64,40,0,24,"17031804000","804000"
"775",1709,98,0,0,0,0,98,14,0,0,14,84,18,0,66,1611,1526,213,51,1262,85,33,0,0,33,52,0,0,52,"17031804102","804102"
"776",1252,114,50,17,0,33,64,0,0,0,0,64,13,0,51,1138,1060,165,99,796,78,45,0,0,45,33,10,0,23,"17031804104","804104"
"777",1053,26,0,0,0,0,26,8,0,0,8,18,0,0,18,1027,968,165,23,780,59,27,10,0,17,32,0,0,32,"17031804105","804105"
"778",1588,61,47,12,27,8,14,0,0,0,0,14,0,0,14,1527,1402,293,37,1072,125,15,0,0,15,110,10,0,100,"17031804106","804106"
"779",567,18,0,0,0,0,18,0,0,0,0,18,0,0,18,549,374,245,38,91,175,106,71,0,35,69,0,0,69,"17031804108","804108"
"780",491,57,57,0,19,38,0,0,0,0,0,0,0,0,0,434,408,90,22,296,26,6,0,0,6,20,0,0,20,"17031804109","804109"
"781",1844,195,162,146,0,16,33,0,0,0,0,33,0,0,33,1649,1535,266,42,1227,114,0,0,0,0,114,0,0,114,"17031804201","804201"
"782",1846,11,0,0,0,0,11,11,0,0,11,0,0,0,0,1835,1584,383,82,1119,251,98,0,0,98,153,16,0,137,"17031804202","804202"
"783",2163,161,14,0,0,14,147,80,0,0,80,67,22,22,23,2002,1389,370,47,972,613,202,121,48,33,411,77,10,324,"17031804305","804305"
"784",1487,106,14,0,0,14,92,0,0,0,0,92,20,0,72,1381,1199,372,93,734,182,58,0,0,58,124,32,0,92,"17031804306","804306"
"785",994,54,30,0,0,30,24,0,0,0,0,24,7,0,17,940,887,318,23,546,53,29,15,14,0,24,8,0,16,"17031804308","804308"
"786",855,73,0,0,0,0,73,0,0,0,0,73,40,0,33,782,541,129,50,362,241,143,19,3,121,98,49,0,49,"17031804309","804309"
"787",2344,33,0,0,0,0,33,0,0,0,0,33,12,0,21,2311,1895,491,98,1306,416,14,14,0,0,402,53,0,349,"17031804310","804310"
"788",2159,202,161,30,27,104,41,0,0,0,0,41,0,0,41,1957,1910,556,144,1210,47,18,18,0,0,29,29,0,0,"17031804311","804311"
"789",1631,158,158,158,0,0,0,0,0,0,0,0,0,0,0,1473,1277,430,39,808,196,0,0,0,0,196,0,17,179,"17031804403","804403"
"790",1642,167,167,0,0,167,0,0,0,0,0,0,0,0,0,1475,1240,304,52,884,235,46,16,0,30,189,104,0,85,"17031804404","804404"
"791",1539,530,321,26,26,269,209,0,0,0,0,209,107,10,92,1009,673,327,37,309,336,198,101,0,97,138,0,0,138,"17031804405","804405"
"792",1770,221,70,16,24,30,151,0,0,0,0,151,36,0,115,1549,1312,474,121,717,237,36,30,0,6,201,35,30,136,"17031804406","804406"
"793",802,25,16,0,0,16,9,0,0,0,0,9,0,0,9,777,552,110,48,394,225,41,0,0,41,184,0,0,184,"17031804505","804505"
"794",1424,9,0,0,0,0,9,0,0,0,0,9,0,0,9,1415,1259,179,61,1019,156,70,60,0,10,86,23,0,63,"17031804506","804506"
"795",3051,96,0,0,0,0,96,0,0,0,0,96,18,26,52,2955,2808,889,163,1756,147,39,39,0,0,108,23,0,85,"17031804507","804507"
"796",858,522,447,161,7,279,75,0,0,0,0,75,0,0,75,336,292,171,5,116,44,0,0,0,0,44,4,3,37,"17031804508","804508"
"797",1648,499,27,9,0,18,472,0,0,0,0,472,172,0,300,1149,996,270,56,670,153,23,0,23,0,130,10,0,120,"17031804509","804509"
"798",2033,349,256,130,0,126,93,0,0,0,0,93,53,0,40,1684,1162,325,48,789,522,117,0,26,91,405,84,34,287,"17031804510","804510"
"799",897,229,229,112,0,117,0,0,0,0,0,0,0,0,0,668,509,207,26,276,159,51,0,0,51,108,13,0,95,"17031804511","804511"
"800",970,193,36,0,12,24,157,0,0,0,0,157,87,0,70,777,554,189,50,315,223,34,16,0,18,189,0,0,189,"17031804603","804603"
"801",1649,0,0,0,0,0,0,0,0,0,0,0,0,0,0,1649,1404,311,78,1015,245,171,39,38,94,74,17,0,57,"17031804606","804606"
"802",1521,92,57,20,0,37,35,0,0,0,0,35,35,0,0,1429,1219,171,65,983,210,100,56,0,44,110,16,0,94,"17031804607","804607"
"803",696,91,7,0,0,7,84,0,0,0,0,84,59,0,25,605,500,84,55,361,105,0,0,0,0,105,16,0,89,"17031804608","804608"
"804",1166,29,29,0,0,29,0,0,0,0,0,0,0,0,0,1137,1024,319,81,624,113,113,0,0,113,0,0,0,0,"17031804609","804609"
"805",362,30,30,30,0,0,0,0,0,0,0,0,0,0,0,332,238,109,16,113,94,0,0,0,0,94,0,0,94,"17031804610","804610"
"806",721,104,88,0,0,88,16,16,16,0,0,0,0,0,0,617,547,164,9,374,70,27,27,0,0,43,0,0,43,"17031804611","804611"
"807",1635,196,178,0,0,178,18,0,0,0,0,18,0,18,0,1439,778,330,18,430,661,131,66,22,43,530,194,0,336,"17031804701","804701"
"808",926,243,66,14,8,44,177,0,0,0,0,177,13,12,152,683,556,184,18,354,127,0,0,0,0,127,28,8,91,"17031804705","804705"
"809",578,27,27,0,0,27,0,0,0,0,0,0,0,0,0,551,519,163,35,321,32,18,0,0,18,14,6,0,8,"17031804706","804706"
"810",1455,89,0,0,0,0,89,0,0,0,0,89,0,0,89,1366,1102,218,128,756,264,38,0,0,38,226,146,0,80,"17031804709","804709"
"811",896,0,0,0,0,0,0,0,0,0,0,0,0,0,0,896,731,242,31,458,165,55,0,0,55,110,26,13,71,"17031804710","804710"
"812",2182,175,0,0,0,0,175,0,0,0,0,175,41,38,96,2007,1522,623,114,785,485,79,15,0,64,406,57,33,316,"17031804711","804711"
"813",1386,150,142,30,28,84,8,0,0,0,0,8,8,0,0,1236,1015,306,52,657,221,136,35,0,101,85,44,0,41,"17031804712","804712"
"814",752,0,0,0,0,0,0,0,0,0,0,0,0,0,0,752,653,177,28,448,99,44,0,0,44,55,22,0,33,"17031804713","804713"
"815",697,0,0,0,0,0,0,0,0,0,0,0,0,0,0,697,511,138,7,366,186,11,11,0,0,175,54,0,121,"17031804714","804714"
"816",787,102,102,43,0,59,0,0,0,0,0,0,0,0,0,685,554,102,33,419,131,38,29,0,9,93,55,0,38,"17031804715","804715"
"817",1408,124,124,42,0,82,0,0,0,0,0,0,0,0,0,1284,950,214,59,677,334,0,0,0,0,334,87,0,247,"17031804716","804716"
"818",1271,40,12,0,0,12,28,0,0,0,0,28,28,0,0,1231,1032,340,94,598,199,54,0,0,54,145,49,0,96,"17031804803","804803"
"819",1495,128,24,0,0,24,104,43,0,0,43,61,27,0,34,1367,945,483,1,461,422,199,148,12,39,223,17,0,206,"17031804804","804804"
"820",1866,68,49,0,17,32,19,0,0,0,0,19,0,0,19,1798,1379,393,79,907,419,34,0,0,34,385,42,68,275,"17031804805","804805"
"821",1006,205,157,11,8,138,48,0,0,0,0,48,8,0,40,801,661,124,36,501,140,7,7,0,0,133,0,16,117,"17031804806","804806"
"822",1277,129,84,0,0,84,45,0,0,0,0,45,7,7,31,1148,840,285,67,488,308,41,8,14,19,267,0,0,267,"17031804807","804807"
"823",476,16,0,0,0,0,16,0,0,0,0,16,0,0,16,460,460,93,29,338,0,0,0,0,0,0,0,0,0,"17031804808","804808"
"824",806,35,0,0,0,0,35,0,0,0,0,35,0,0,35,771,723,208,75,440,48,0,0,0,0,48,0,17,31,"17031804809","804809"
"825",1663,194,0,0,0,0,194,0,0,0,0,194,29,60,105,1469,1186,516,19,651,283,55,0,12,43,228,39,0,189,"17031804810","804810"
"826",1685,80,36,0,0,36,44,15,15,0,0,29,0,0,29,1605,1487,320,83,1084,118,0,0,0,0,118,59,18,41,"17031804901","804901"
"827",1195,0,0,0,0,0,0,0,0,0,0,0,0,0,0,1195,1121,337,42,742,74,0,0,0,0,74,15,0,59,"17031804902","804902"
"828",1083,85,0,0,0,0,85,0,0,0,0,85,43,42,0,998,926,152,69,705,72,33,0,0,33,39,0,0,39,"17031805001","805001"
"829",1301,117,50,36,0,14,67,25,0,0,25,42,17,0,25,1184,1053,247,72,734,131,42,12,0,30,89,0,0,89,"17031805002","805002"
"830",2061,721,428,252,0,176,293,40,0,0,40,253,48,0,205,1340,1121,482,3,636,219,136,0,43,93,83,53,0,30,"17031805105","805105"
"831",468,36,31,31,0,0,5,5,0,0,5,0,0,0,0,432,393,146,7,240,39,0,0,0,0,39,26,13,0,"17031805106","805106"
"832",1384,285,186,71,0,115,99,0,0,0,0,99,51,0,48,1099,621,311,30,280,478,215,109,17,89,263,81,45,137,"17031805107","805107"
"833",1742,200,150,23,0,127,50,0,0,0,0,50,0,0,50,1542,1169,350,74,745,373,330,66,65,199,43,5,0,38,"17031805108","805108"
"834",851,34,0,0,0,0,34,0,0,0,0,34,0,0,34,817,739,262,42,435,78,0,0,0,0,78,26,0,52,"17031805109","805109"
"835",640,0,0,0,0,0,0,0,0,0,0,0,0,0,0,640,524,203,60,261,116,64,33,0,31,52,0,0,52,"17031805110","805110"
"836",1584,257,216,76,0,140,41,0,0,0,0,41,27,0,14,1327,941,334,108,499,386,68,56,0,12,318,67,0,251,"17031805111","805111"
"837",581,65,34,34,0,0,31,25,8,0,17,6,0,0,6,516,471,178,0,293,45,31,0,0,31,14,0,0,14,"17031805112","805112"
"838",511,100,79,19,29,31,21,0,0,0,0,21,0,0,21,411,313,52,18,243,98,14,0,0,14,84,40,0,44,"17031805201","805201"
"839",1013,98,20,10,0,10,78,0,0,0,0,78,0,0,78,915,843,366,57,420,72,9,0,0,9,63,17,6,40,"17031805202","805202"
"840",723,114,56,15,0,41,58,0,0,0,0,58,0,0,58,609,474,163,23,288,135,20,20,0,0,115,28,0,87,"17031805301","805301"
"841",570,42,42,10,11,21,0,0,0,0,0,0,0,0,0,528,519,209,39,271,9,0,0,0,0,9,0,0,9,"17031805302","805302"
"842",740,40,0,0,0,0,40,0,0,0,0,40,10,0,30,700,644,127,44,473,56,14,0,0,14,42,13,0,29,"17031805401","805401"
"843",827,27,0,0,0,0,27,0,0,0,0,27,14,0,13,800,636,176,13,447,164,40,0,0,40,124,39,15,70,"17031805402","805402"
"844",881,140,0,0,0,0,140,0,0,0,0,140,29,0,111,741,548,85,39,424,193,158,0,0,158,35,0,0,35,"17031805501","805501"
"845",1030,18,18,0,0,18,0,0,0,0,0,0,0,0,0,1012,826,129,60,637,186,76,0,0,76,110,0,0,110,"17031805502","805502"
"846",1380,59,33,11,0,22,26,8,8,0,0,18,0,0,18,1321,1209,236,87,886,112,11,0,0,11,101,18,0,83,"17031805600","805600"
"847",1318,42,23,23,0,0,19,0,0,0,0,19,0,0,19,1276,1075,279,31,765,201,0,0,0,0,201,40,0,161,"17031805701","805701"
"848",458,10,10,0,0,10,0,0,0,0,0,0,0,0,0,448,405,105,25,275,43,4,0,0,4,39,0,4,35,"17031805702","805702"
"849",305,0,0,0,0,0,0,0,0,0,0,0,0,0,0,305,274,82,0,192,31,0,0,0,0,31,0,0,31,"17031805801","805801"
"850",1223,136,74,24,0,50,62,0,0,0,0,62,13,0,49,1087,1012,192,68,752,75,8,0,0,8,67,0,0,67,"17031805802","805802"
"851",631,27,27,20,0,7,0,0,0,0,0,0,0,0,0,604,480,213,27,240,124,38,0,0,38,86,38,0,48,"17031805901","805901"
"852",1337,261,234,210,0,24,27,0,0,0,0,27,0,0,27,1076,1035,248,0,787,41,0,0,0,0,41,0,41,0,"17031805902","805902"
"853",1329,210,72,10,17,45,138,0,0,0,0,138,95,0,43,1119,846,245,32,569,273,152,84,34,34,121,0,14,107,"17031806001","806001"
"854",1792,162,43,29,14,0,119,0,0,0,0,119,61,0,58,1630,1155,381,27,747,475,59,20,19,20,416,30,12,374,"17031806002","806002"
"855",1511,65,65,24,0,41,0,0,0,0,0,0,0,0,0,1446,1205,305,95,805,241,33,10,0,23,208,46,32,130,"17031806003","806003"
"856",1285,258,242,20,0,222,16,0,0,0,0,16,16,0,0,1027,736,198,32,506,291,145,40,16,89,146,19,17,110,"17031806004","806004"
"857",804,11,0,0,0,0,11,0,0,0,0,11,0,0,11,793,716,170,102,444,77,0,0,0,0,77,34,7,36,"17031806102","806102"
"858",971,157,122,53,0,69,35,0,0,0,0,35,0,0,35,814,653,211,17,425,161,33,0,0,33,128,30,0,98,"17031806103","806103"
"859",942,316,215,34,15,166,101,0,0,0,0,101,0,0,101,626,503,214,36,253,123,74,0,37,37,49,0,14,35,"17031806104","806104"
"860",840,241,191,52,41,98,50,0,0,0,0,50,0,17,33,599,535,342,24,169,64,0,0,0,0,64,37,0,27,"17031806201","806201"
"861",508,47,29,0,0,29,18,0,0,0,0,18,0,0,18,461,446,89,20,337,15,0,0,0,0,15,0,0,15,"17031806202","806202"
"862",1001,21,21,0,10,11,0,0,0,0,0,0,0,0,0,980,816,150,61,605,164,23,0,0,23,141,24,15,102,"17031806300","806300"
"863",526,58,36,14,0,22,22,0,0,0,0,22,22,0,0,468,453,184,17,252,15,5,0,0,5,10,0,0,10,"17031806400","806400"
"864",528,85,85,32,11,42,0,0,0,0,0,0,0,0,0,443,443,134,24,285,0,0,0,0,0,0,0,0,0,"17031806501","806501"
"865",826,116,116,26,14,76,0,0,0,0,0,0,0,0,0,710,612,247,68,297,98,46,0,12,34,52,0,0,52,"17031806502","806502"
"866",745,33,21,11,0,10,12,0,0,0,0,12,0,0,12,712,573,124,65,384,139,30,30,0,0,109,54,0,55,"17031806600","806600"
"867",1132,0,0,0,0,0,0,0,0,0,0,0,0,0,0,1132,1015,323,28,664,117,53,0,0,53,64,11,0,53,"17031806700","806700"
"868",443,6,0,0,0,0,6,0,0,0,0,6,0,0,6,437,395,130,35,230,42,25,0,0,25,17,0,0,17,"17031806801","806801"
"869",613,0,0,0,0,0,0,0,0,0,0,0,0,0,0,613,448,85,0,363,165,47,0,0,47,118,16,0,102,"17031806802","806802"
"870",707,0,0,0,0,0,0,0,0,0,0,0,0,0,0,707,388,208,26,154,319,24,12,0,12,295,105,0,190,"17031806900","806900"
"871",1109,209,26,19,0,7,183,25,0,0,25,158,75,0,83,900,744,162,45,537,156,13,0,0,13,143,33,0,110,"17031807000","807000"
"872",1098,133,76,20,0,56,57,0,0,0,0,57,0,0,57,965,823,170,49,604,142,17,0,0,17,125,24,0,101,"17031807100","807100"
"873",1122,143,107,15,0,92,36,0,0,0,0,36,0,0,36,979,817,159,17,641,162,73,28,0,45,89,0,9,80,"17031807200","807200"
"874",1255,445,239,93,47,99,206,37,20,0,17,169,0,0,169,810,624,203,0,421,186,0,0,0,0,186,111,0,75,"17031807300","807300"
"875",1601,344,137,11,10,116,207,0,0,0,0,207,0,0,207,1257,969,363,76,530,288,178,97,0,81,110,0,13,97,"17031807400","807400"
"876",623,0,0,0,0,0,0,0,0,0,0,0,0,0,0,623,555,181,43,331,68,0,0,0,0,68,27,0,41,"17031807500","807500"
"877",1412,134,110,0,30,80,24,0,0,0,0,24,0,0,24,1278,1089,177,104,808,189,55,27,10,18,134,41,0,93,"17031807600","807600"
"878",1314,625,553,108,37,408,72,0,0,0,0,72,36,0,36,689,582,84,0,498,107,25,0,0,25,82,24,14,44,"17031807700","807700"
"879",597,13,0,0,0,0,13,0,0,0,0,13,0,0,13,584,488,159,19,310,96,37,27,0,10,59,18,14,27,"17031807800","807800"
"880",799,23,0,0,0,0,23,0,0,0,0,23,0,0,23,776,710,74,64,572,66,34,17,0,17,32,12,11,9,"17031807900","807900"
"881",639,12,0,0,0,0,12,0,0,0,0,12,0,0,12,627,595,92,47,456,32,0,0,0,0,32,11,0,21,"17031808001","808001"
"882",1123,133,83,10,10,63,50,13,0,0,13,37,0,0,37,990,740,157,42,541,250,146,30,0,116,104,0,0,104,"17031808002","808002"
"883",290,0,0,0,0,0,0,0,0,0,0,0,0,0,0,290,221,80,11,130,69,0,0,0,0,69,0,0,69,"17031808100","808100"
"884",1058,298,205,68,0,137,93,0,0,0,0,93,0,17,76,760,629,229,38,362,131,8,0,8,0,123,17,0,106,"17031808200","808200"
"885",1174,272,87,0,12,75,185,32,0,0,32,153,34,40,79,902,842,283,21,538,60,45,0,0,45,15,0,0,15,"17031808301","808301"
"886",779,16,0,0,0,0,16,0,0,0,0,16,0,0,16,763,608,236,14,358,155,0,0,0,0,155,0,0,155,"17031808302","808302"
"887",970,105,87,31,0,56,18,0,0,0,0,18,0,0,18,865,828,195,17,616,37,0,0,0,0,37,0,0,37,"17031808400","808400"
"888",852,0,0,0,0,0,0,0,0,0,0,0,0,0,0,852,809,148,8,653,43,30,0,0,30,13,0,0,13,"17031808500","808500"
"889",450,3,3,0,0,3,0,0,0,0,0,0,0,0,0,447,411,74,15,322,36,22,4,0,18,14,0,0,14,"17031808600","808600"
"890",88,5,0,0,0,0,5,0,0,0,0,5,0,0,5,83,83,20,0,63,0,0,0,0,0,0,0,0,0,"17031808702","808702"
"891",798,39,39,23,9,7,0,0,0,0,0,0,0,0,0,759,748,227,32,489,11,0,0,0,0,11,0,0,11,"17031808800","808800"
"892",1086,52,9,0,0,9,43,0,0,0,0,43,0,0,43,1034,823,290,36,497,211,74,0,13,61,137,37,9,91,"17031808900","808900"
"893",991,0,0,0,0,0,0,0,0,0,0,0,0,0,0,991,943,231,65,647,48,24,12,12,0,24,0,0,24,"17031809000","809000"
"894",935,0,0,0,0,0,0,0,0,0,0,0,0,0,0,935,723,238,25,460,212,66,0,0,66,146,6,0,140,"17031809100","809100"
"895",1426,325,87,34,0,53,238,0,0,0,0,238,38,0,200,1101,555,126,44,385,546,165,77,0,88,381,87,9,285,"17031809200","809200"
"896",504,33,33,0,0,33,0,0,0,0,0,0,0,0,0,471,471,116,49,306,0,0,0,0,0,0,0,0,0,"17031809300","809300"
"897",285,20,20,20,0,0,0,0,0,0,0,0,0,0,0,265,181,58,0,123,84,0,0,0,0,84,15,0,69,"17031809400","809400"
"898",543,10,10,10,0,0,0,0,0,0,0,0,0,0,0,533,452,149,15,288,81,17,17,0,0,64,11,0,53,"17031809500","809500"
"899",738,124,0,0,0,0,124,0,0,0,0,124,0,44,80,614,524,187,6,331,90,0,0,0,0,90,3,0,87,"17031809600","809600"
"900",1184,63,0,0,0,0,63,0,0,0,0,63,0,0,63,1121,812,214,13,585,309,122,7,41,74,187,116,0,71,"17031809700","809700"
"901",657,35,35,0,0,35,0,0,0,0,0,0,0,0,0,622,591,122,62,407,31,24,0,0,24,7,0,0,7,"17031809800","809800"
"902",648,31,21,0,0,21,10,0,0,0,0,10,0,0,10,617,610,243,43,324,7,0,0,0,0,7,7,0,0,"17031809900","809900"
"903",902,110,33,0,0,33,77,0,0,0,0,77,46,0,31,792,635,293,47,295,157,60,0,0,60,97,51,0,46,"17031810000","810000"
"904",988,92,13,13,0,0,79,38,10,9,19,41,0,22,19,896,865,380,100,385,31,22,0,0,22,9,0,0,9,"17031810100","810100"
"905",1594,336,260,54,7,199,76,0,0,0,0,76,0,0,76,1258,635,405,30,200,623,0,0,0,0,623,150,39,434,"17031810200","810200"
"906",674,69,42,14,0,28,27,0,0,0,0,27,0,0,27,605,412,81,70,261,193,43,32,0,11,150,0,7,143,"17031810301","810301"
"907",845,39,39,11,18,10,0,0,0,0,0,0,0,0,0,806,499,128,13,358,307,46,0,0,46,261,30,36,195,"17031810302","810302"
"908",1133,41,0,0,0,0,41,41,0,0,41,0,0,0,0,1092,986,157,144,685,106,0,0,0,0,106,9,9,88,"17031810400","810400"
"909",716,61,9,0,0,9,52,0,0,0,0,52,0,0,52,655,551,145,0,406,104,46,36,10,0,58,0,0,58,"17031810501","810501"
"910",757,50,32,0,0,32,18,0,0,0,0,18,9,0,9,707,633,149,47,437,74,29,14,0,15,45,0,7,38,"17031810502","810502"
"911",815,80,80,40,0,40,0,0,0,0,0,0,0,0,0,735,456,84,38,334,279,103,59,0,44,176,18,0,158,"17031810600","810600"
"912",959,124,47,10,0,37,77,34,0,0,34,43,9,0,34,835,607,156,49,402,228,7,0,0,7,221,65,0,156,"17031810701","810701"
"913",758,26,0,0,0,0,26,0,0,0,0,26,0,0,26,732,573,124,13,436,159,16,0,0,16,143,57,0,86,"17031810702","810702"
"914",1214,35,0,0,0,0,35,35,26,0,9,0,0,0,0,1179,886,296,31,559,293,60,44,0,16,233,68,0,165,"17031810800","810800"
"915",832,31,0,0,0,0,31,0,0,0,0,31,31,0,0,801,579,124,53,402,222,26,0,0,26,196,0,0,196,"17031810900","810900"
"916",931,20,0,0,0,0,20,0,0,0,0,20,0,0,20,911,833,264,58,511,78,0,0,0,0,78,17,11,50,"17031811000","811000"
"917",884,156,113,49,16,48,43,0,0,0,0,43,33,0,10,728,674,287,18,369,54,14,0,0,14,40,0,0,40,"17031811100","811100"
"918",1391,198,88,66,0,22,110,30,20,10,0,80,80,0,0,1193,747,156,11,580,446,189,13,0,176,257,56,0,201,"17031811200","811200"
"919",1185,88,88,30,29,29,0,0,0,0,0,0,0,0,0,1097,844,116,34,694,253,63,0,0,63,190,91,9,90,"17031811301","811301"
"920",1169,383,98,23,0,75,285,120,46,0,74,165,35,0,130,786,511,118,43,350,275,35,19,5,11,240,0,30,210,"17031811302","811302"
"921",1365,221,160,37,0,123,61,0,0,0,0,61,0,33,28,1144,819,214,37,568,325,19,0,0,19,306,86,23,197,"17031811401","811401"
"922",1004,265,168,21,0,147,97,32,32,0,0,65,25,0,40,739,387,73,50,264,352,197,34,32,131,155,35,6,114,"17031811402","811402"
"923",1039,158,136,52,0,84,22,0,0,0,0,22,0,11,11,881,730,93,0,637,151,38,0,0,38,113,11,23,79,"17031811500","811500"
"924",1421,350,140,24,24,92,210,0,0,0,0,210,0,0,210,1071,843,201,55,587,228,16,16,0,0,212,1,0,211,"17031811600","811600"
"925",995,210,123,72,4,47,87,43,43,0,0,44,44,0,0,785,542,169,15,358,243,109,22,0,87,134,18,10,106,"17031811701","811701"
"926",1396,130,100,20,10,70,30,0,0,0,0,30,23,7,0,1266,1086,278,79,729,180,73,48,8,17,107,35,23,49,"17031811702","811702"
"927",1076,132,112,0,0,112,20,20,10,0,10,0,0,0,0,944,735,239,95,401,209,74,7,0,67,135,56,0,79,"17031811800","811800"
"928",1526,37,0,0,0,0,37,0,0,0,0,37,12,0,25,1489,1375,185,59,1131,114,70,0,0,70,44,0,0,44,"17031811900","811900"
"929",1355,84,0,0,0,0,84,84,0,0,84,0,0,0,0,1271,1176,379,84,713,95,23,0,0,23,72,0,0,72,"17031812000","812000"
"930",1227,156,0,0,0,0,156,29,0,0,29,127,13,32,82,1071,855,235,61,559,216,19,0,0,19,197,51,7,139,"17031812100","812100"
"931",1211,29,0,0,0,0,29,20,4,0,16,9,0,0,9,1182,1109,303,68,738,73,16,0,0,16,57,11,0,46,"17031812200","812200"
"932",542,81,15,15,0,0,66,0,0,0,0,66,0,18,48,461,334,164,16,154,127,0,0,0,0,127,74,0,53,"17031812301","812301"
"933",674,40,23,0,8,15,17,0,0,0,0,17,0,0,17,634,625,115,7,503,9,9,9,0,0,0,0,0,0,"17031812302","812302"
"934",993,0,0,0,0,0,0,0,0,0,0,0,0,0,0,993,949,184,48,717,44,44,0,0,44,0,0,0,0,"17031812400","812400"
"935",949,180,43,16,0,27,137,0,0,0,0,137,42,0,95,769,678,204,31,443,91,9,0,0,9,82,42,0,40,"17031812500","812500"
"936",652,56,19,0,0,19,37,0,0,0,0,37,9,0,28,596,365,166,23,176,231,76,31,0,45,155,9,0,146,"17031812600","812600"
"937",639,42,0,0,0,0,42,0,0,0,0,42,0,0,42,597,468,64,30,374,129,0,0,0,0,129,25,10,94,"17031812700","812700"
"938",412,0,0,0,0,0,0,0,0,0,0,0,0,0,0,412,320,185,0,135,92,50,0,28,22,42,0,0,42,"17031812801","812801"
"939",672,100,55,55,0,0,45,0,0,0,0,45,28,0,17,572,489,95,15,379,83,0,0,0,0,83,10,0,73,"17031812802","812802"
"940",1499,223,64,0,0,64,159,0,0,0,0,159,82,0,77,1276,1017,412,68,537,259,94,0,9,85,165,7,0,158,"17031812900","812900"
"941",908,96,24,0,0,24,72,0,0,0,0,72,15,0,57,812,653,198,13,442,159,33,0,0,33,126,24,0,102,"17031813000","813000"
"942",1165,6,0,0,0,0,6,0,0,0,0,6,0,0,6,1159,858,194,86,578,301,0,0,0,0,301,56,30,215,"17031813100","813100"
"943",1146,0,0,0,0,0,0,0,0,0,0,0,0,0,0,1146,968,268,126,574,178,0,0,0,0,178,71,0,107,"17031813200","813200"
"944",1234,438,142,81,1,60,296,84,0,0,84,212,48,0,164,796,544,171,54,319,252,101,53,2,46,151,51,0,100,"17031813301","813301"
"945",1337,293,47,15,6,26,246,40,0,0,40,206,0,10,196,1044,916,109,116,691,128,76,33,0,43,52,38,0,14,"17031813302","813302"
"946",2967,932,350,137,9,204,582,102,21,0,81,480,193,32,255,2035,1586,396,49,1141,449,238,73,0,165,211,64,0,147,"17031813400","813400"
"947",2490,292,188,22,57,109,104,65,30,0,35,39,0,0,39,2198,1516,526,76,914,682,290,122,36,132,392,143,9,240,"17031813500","813500"
"948",1668,443,271,43,19,209,172,29,15,0,14,143,18,17,108,1225,1016,289,59,668,209,89,8,0,81,120,56,0,64,"17031813600","813600"
"949",1157,390,175,18,38,119,215,0,0,0,0,215,88,0,127,767,518,204,16,298,249,127,53,0,74,122,61,0,61,"17031813701","813701"
"950",1523,400,356,77,22,257,44,22,0,0,22,22,22,0,0,1123,950,238,45,667,173,63,0,0,63,110,27,0,83,"17031813702","813702"
"951",935,202,60,21,0,39,142,22,17,0,5,120,35,0,85,733,576,27,39,510,157,10,0,0,10,147,27,0,120,"17031813801","813801"
"952",1733,451,105,47,0,58,346,0,0,0,0,346,117,6,223,1282,1010,424,50,536,272,213,109,0,104,59,0,0,59,"17031813802","813802"
"953",2340,602,446,107,42,297,156,31,6,6,19,125,90,0,35,1738,1204,378,41,785,534,131,44,0,87,403,143,28,232,"17031813900","813900"
"954",1383,321,85,19,6,60,236,0,0,0,0,236,22,17,197,1062,767,222,0,545,295,251,110,16,125,44,25,0,19,"17031814000","814000"
"955",1315,536,383,91,57,235,153,0,0,0,0,153,89,0,64,779,677,189,37,451,102,0,0,0,0,102,38,0,64,"17031814100","814100"
"956",2343,852,283,51,15,217,569,115,46,10,59,454,210,50,194,1491,1044,214,41,789,447,118,81,0,37,329,58,0,271,"17031814200","814200"
"957",1665,455,242,96,51,95,213,0,0,0,0,213,97,0,116,1210,1059,377,46,636,151,54,0,22,32,97,40,0,57,"17031814300","814300"
"958",2453,651,257,20,0,237,394,151,51,0,100,243,182,0,61,1802,1675,311,194,1170,127,28,0,0,28,99,12,0,87,"17031814400","814400"
"959",1212,96,72,0,0,72,24,0,0,0,0,24,13,0,11,1116,815,123,10,682,301,17,9,0,8,284,92,6,186,"17031814500","814500"
"960",1678,307,145,11,7,127,162,90,0,30,60,72,72,0,0,1371,996,329,40,627,375,136,66,0,70,239,91,6,142,"17031814600","814600"
"961",2032,350,118,14,26,78,232,0,0,0,0,232,145,78,9,1682,1507,284,63,1160,175,17,17,0,0,158,23,0,135,"17031814700","814700"
"962",1402,75,0,0,0,0,75,0,0,0,0,75,16,0,59,1327,828,265,79,484,499,170,0,0,170,329,33,26,270,"17031814800","814800"
"963",1879,530,16,0,0,16,514,224,82,0,142,290,58,0,232,1349,709,210,38,461,640,63,48,0,15,577,235,0,342,"17031814900","814900"
"964",1467,765,131,79,0,52,634,14,0,0,14,620,173,40,407,702,344,99,52,193,358,118,0,0,118,240,79,0,161,"17031815000","815000"
"965",1470,304,257,93,27,137,47,0,0,0,0,47,17,0,30,1166,723,197,53,473,443,17,6,0,11,426,194,7,225,"17031815100","815100"
"966",1526,235,93,0,0,93,142,13,13,0,0,129,59,12,58,1291,868,192,102,574,423,208,86,0,122,215,44,0,171,"17031815200","815200"
"967",921,102,73,13,0,60,29,0,0,0,0,29,0,0,29,819,687,319,11,357,132,34,19,0,15,98,0,17,81,"17031815300","815300"
"968",1040,155,0,0,0,0,155,54,0,0,54,101,30,0,71,885,664,221,24,419,221,72,0,0,72,149,22,22,105,"17031815400","815400"
"969",2188,518,239,47,0,192,279,0,0,0,0,279,15,0,264,1670,1272,291,81,900,398,90,16,0,74,308,94,62,152,"17031815500","815500"
"970",1077,61,26,0,0,26,35,0,0,0,0,35,0,0,35,1016,552,47,12,493,464,55,13,0,42,409,112,0,297,"17031815600","815600"
"971",1096,9,0,0,0,0,9,9,9,0,0,0,0,0,0,1087,957,170,62,725,130,8,0,0,8,122,32,0,90,"17031815701","815701"
"972",1119,49,17,17,0,0,32,0,0,0,0,32,0,0,32,1070,1024,226,29,769,46,30,0,0,30,16,0,0,16,"17031815702","815702"
"973",248,0,0,0,0,0,0,0,0,0,0,0,0,0,0,248,211,79,7,125,37,10,0,0,10,27,0,0,27,"17031815800","815800"
"974",600,162,0,0,0,0,162,9,9,0,0,153,0,0,153,438,245,139,7,99,193,97,41,0,56,96,0,0,96,"17031815900","815900"
"975",586,49,0,0,0,0,49,0,0,0,0,49,17,0,32,537,322,81,18,223,215,5,5,0,0,210,50,9,151,"17031816000","816000"
"976",1215,166,75,0,0,75,91,32,32,0,0,59,14,0,45,1049,623,238,10,375,426,124,0,0,124,302,161,0,141,"17031816100","816100"
"977",670,86,13,0,0,13,73,0,0,0,0,73,46,9,18,584,448,181,24,243,136,1,0,0,1,135,60,0,75,"17031816200","816200"
"978",1422,316,135,34,15,86,181,39,13,0,26,142,50,0,92,1106,826,282,28,516,280,55,38,0,17,225,59,0,166,"17031816300","816300"
"979",1846,529,296,93,0,203,233,48,12,0,36,185,87,0,98,1317,858,169,88,601,459,138,119,0,19,321,125,15,181,"17031816401","816401"
"980",1368,399,127,75,18,34,272,0,0,0,0,272,109,16,147,969,719,202,0,517,250,204,141,0,63,46,13,0,33,"17031816402","816402"
"981",1594,392,292,86,20,186,100,0,0,0,0,100,44,0,56,1202,701,124,80,497,501,256,16,19,221,245,65,22,158,"17031816500","816500"
"982",1525,307,128,12,12,104,179,91,69,11,11,88,20,0,68,1218,846,268,58,520,372,272,106,0,166,100,43,0,57,"17031816600","816600"
"983",908,213,213,66,0,147,0,0,0,0,0,0,0,0,0,695,564,207,23,334,131,64,37,0,27,67,36,0,31,"17031816700","816700"
"984",1240,59,0,0,0,0,59,0,0,0,0,59,0,0,59,1181,945,182,38,725,236,141,22,0,119,95,18,14,63,"17031816800","816800"
"985",1662,353,178,54,0,124,175,0,0,0,0,175,27,0,148,1309,757,253,48,456,552,64,29,0,35,488,47,24,417,"17031816900","816900"
"986",1190,213,60,5,9,46,153,46,31,0,15,107,56,27,24,977,627,129,23,475,350,115,60,9,46,235,47,5,183,"17031817000","817000"
"987",1041,120,58,0,0,58,62,0,0,0,0,62,32,0,30,921,424,82,56,286,497,9,0,0,9,488,67,6,415,"17031817101","817101"
"988",817,144,0,0,0,0,144,0,0,0,0,144,82,0,62,673,299,138,0,161,374,66,0,0,66,308,137,0,171,"17031817102","817102"
"989",932,516,66,8,29,29,450,0,0,0,0,450,75,0,375,416,61,14,0,47,355,17,17,0,0,338,67,52,219,"17031817200","817200"
"990",741,245,16,0,0,16,229,0,0,0,0,229,59,0,170,496,279,80,20,179,217,8,5,0,3,209,118,6,85,"17031817300","817300"
"991",1197,204,23,12,11,0,181,76,26,25,25,105,21,0,84,993,743,165,31,547,250,163,52,0,111,87,15,0,72,"17031817400","817400"
"992",974,333,105,0,0,105,228,0,0,0,0,228,93,19,116,641,462,110,66,286,179,0,0,0,0,179,0,14,165,"17031817500","817500"
"993",823,281,87,0,0,87,194,0,0,0,0,194,15,0,179,542,274,85,4,185,268,0,0,0,0,268,67,0,201,"17031817600","817600"
"994",583,105,0,0,0,0,105,0,0,0,0,105,21,0,84,478,277,73,20,184,201,20,0,0,20,181,43,0,138,"17031817700","817700"
"995",855,141,0,0,0,0,141,68,46,0,22,73,0,0,73,714,619,227,71,321,95,50,0,0,50,45,0,0,45,"17031817900","817900"
"996",831,91,39,0,0,39,52,18,0,0,18,34,0,0,34,740,435,103,26,306,305,132,0,0,132,173,42,0,131,"17031818000","818000"
"997",543,52,0,0,0,0,52,0,0,0,0,52,0,0,52,491,433,159,29,245,58,10,0,0,10,48,0,0,48,"17031818100","818100"
"998",1097,66,23,0,0,23,43,32,8,0,24,11,0,0,11,1031,805,392,33,380,226,6,0,0,6,220,65,31,124,"17031818200","818200"
"999",1467,476,270,67,0,203,206,0,0,0,0,206,128,0,78,991,736,115,34,587,255,56,0,15,41,199,53,0,146,"17031818300","818300"
"1000",643,106,0,0,0,0,106,0,0,0,0,106,0,0,106,537,355,168,0,187,182,23,8,0,15,159,31,0,128,"17031818401","818401"
"1001",486,22,22,0,0,22,0,0,0,0,0,0,0,0,0,464,426,121,12,293,38,12,12,0,0,26,9,0,17,"17031818402","818402"
"1002",799,38,0,0,0,0,38,0,0,0,0,38,0,0,38,761,737,171,0,566,24,0,0,0,0,24,0,0,24,"17031818500","818500"
"1003",1248,111,8,0,8,0,103,0,0,0,0,103,0,0,103,1137,789,310,41,438,348,0,0,0,0,348,82,0,266,"17031818600","818600"
"1004",803,25,7,0,0,7,18,18,0,0,18,0,0,0,0,778,490,153,12,325,288,135,22,23,90,153,13,0,140,"17031818700","818700"
"1005",1227,277,50,0,0,50,227,70,29,0,41,157,0,0,157,950,787,190,55,542,163,26,0,0,26,137,80,0,57,"17031818800","818800"
"1006",1019,61,0,0,0,0,61,0,0,0,0,61,30,15,16,958,818,174,3,641,140,12,12,0,0,128,43,0,85,"17031818900","818900"
"1007",1317,14,14,0,0,14,0,0,0,0,0,0,0,0,0,1303,1216,248,65,903,87,16,0,0,16,71,0,0,71,"17031819000","819000"
"1008",878,57,24,0,0,24,33,0,0,0,0,33,0,0,33,821,478,147,30,301,343,19,0,0,19,324,91,0,233,"17031819100","819100"
"1009",1475,247,144,0,11,133,103,0,0,0,0,103,17,0,86,1228,987,305,0,682,241,128,31,0,97,113,0,0,113,"17031819200","819200"
"1010",707,44,17,0,0,17,27,9,6,0,3,18,0,0,18,663,492,295,0,197,171,4,4,0,0,167,26,0,141,"17031819300","819300"
"1011",1230,186,55,0,0,55,131,0,0,0,0,131,0,50,81,1044,883,257,72,554,161,45,0,0,45,116,31,0,85,"17031819400","819400"
"1012",720,23,14,0,0,14,9,0,0,0,0,9,0,0,9,697,571,246,29,296,126,54,0,27,27,72,0,0,72,"17031819500","819500"
"1013",1264,18,18,6,6,6,0,0,0,0,0,0,0,0,0,1246,1101,215,26,860,145,32,7,0,25,113,35,0,78,"17031819600","819600"
"1014",1945,138,57,10,0,47,81,17,0,0,17,64,0,0,64,1807,1708,399,95,1214,99,35,0,0,35,64,7,0,57,"17031819700","819700"
"1015",1844,0,0,0,0,0,0,0,0,0,0,0,0,0,0,1844,1834,279,105,1450,10,10,0,0,10,0,0,0,0,"17031819801","819801"
"1016",703,0,0,0,0,0,0,0,0,0,0,0,0,0,0,703,664,91,47,526,39,18,0,0,18,21,0,0,21,"17031819802","819802"
"1017",1058,63,63,0,0,63,0,0,0,0,0,0,0,0,0,995,987,212,70,705,8,0,0,0,0,8,0,0,8,"17031819900","819900"
"1018",652,40,31,0,0,31,9,0,0,0,0,9,4,0,5,612,578,118,32,428,34,0,0,0,0,34,0,0,34,"17031820000","820000"
"1019",1489,17,0,0,0,0,17,0,0,0,0,17,17,0,0,1472,1218,234,32,952,254,52,0,0,52,202,0,0,202,"17031820101","820101"
"1020",1113,89,61,46,0,15,28,0,0,0,0,28,28,0,0,1024,689,122,17,550,335,79,64,0,15,256,152,0,104,"17031820103","820103"
"1021",838,220,157,30,0,127,63,35,28,0,7,28,28,0,0,618,541,186,40,315,77,41,0,5,36,36,18,0,18,"17031820104","820104"
"1022",1619,57,0,0,0,0,57,27,0,0,27,30,12,6,12,1562,1446,326,89,1031,116,25,12,0,13,91,20,13,58,"17031820201","820201"
"1023",901,171,162,93,0,69,9,0,0,0,0,9,0,0,9,730,550,104,42,404,180,79,31,21,27,101,15,0,86,"17031820202","820202"
"1024",1507,259,79,16,0,63,180,45,23,0,22,135,102,23,10,1248,794,263,41,490,454,175,99,0,76,279,30,0,249,"17031820300","820300"
"1025",1681,463,186,56,21,109,277,62,18,17,27,215,112,0,103,1218,803,216,59,528,415,236,98,0,138,179,0,23,156,"17031820400","820400"
"1026",1518,382,179,71,0,108,203,84,47,0,37,119,12,53,54,1136,1030,267,56,707,106,45,43,2,0,61,0,5,56,"17031820501","820501"
"1027",789,85,58,14,0,44,27,0,0,0,0,27,0,0,27,704,613,209,50,354,91,18,0,0,18,73,38,0,35,"17031820502","820502"
"1028",1266,173,66,44,0,22,107,0,0,0,0,107,19,10,78,1093,601,99,7,495,492,177,74,71,32,315,105,11,199,"17031820603","820603"
"1029",1154,289,85,0,0,85,204,14,7,7,0,190,29,0,161,865,518,170,61,287,347,64,27,25,12,283,90,24,169,"17031820604","820604"
"1030",1219,533,20,0,0,20,513,36,0,0,36,477,73,53,351,686,235,158,18,59,451,16,0,0,16,435,26,15,394,"17031820605","820605"
"1031",786,60,43,0,0,43,17,0,0,0,0,17,0,0,17,726,687,350,0,337,39,30,10,0,20,9,0,0,9,"17031820606","820606"
"1032",1737,69,0,0,0,0,69,0,0,0,0,69,69,0,0,1668,1004,245,51,708,664,7,7,0,0,657,138,0,519,"17031820700","820700"
"1033",928,65,37,0,0,37,28,0,0,0,0,28,0,0,28,863,508,159,33,316,355,141,42,0,99,214,57,10,147,"17031820800","820800"
"1034",1313,158,59,30,0,29,99,99,0,0,99,0,0,0,0,1155,1034,235,35,764,121,67,0,0,67,54,18,8,28,"17031820901","820901"
"1035",1427,383,346,42,26,278,37,4,0,0,4,33,16,0,17,1044,947,217,56,674,97,27,9,0,18,70,15,9,46,"17031820902","820902"
"1036",1357,254,219,96,35,88,35,0,0,0,0,35,12,6,17,1103,936,231,22,683,167,36,0,0,36,131,27,26,78,"17031821001","821001"
"1037",1210,199,186,20,27,139,13,0,0,0,0,13,0,0,13,1011,845,103,42,700,166,40,0,0,40,126,62,0,64,"17031821002","821002"
"1038",1085,200,96,0,0,96,104,72,37,0,35,32,0,0,32,885,811,202,34,575,74,29,7,0,22,45,19,0,26,"17031821101","821101"
"1039",955,205,82,34,0,48,123,0,0,0,0,123,0,34,89,750,561,97,8,456,189,90,0,0,90,99,25,32,42,"17031821102","821102"
"1040",1373,278,150,10,40,100,128,0,0,0,0,128,37,0,91,1095,630,124,0,506,465,111,0,9,102,354,51,0,303,"17031821200","821200"
"1041",1744,702,0,0,0,0,702,228,39,38,151,474,216,45,213,1042,633,149,13,471,409,105,73,0,32,304,157,0,147,"17031821300","821300"
"1042",785,244,128,0,0,128,116,0,0,0,0,116,12,0,104,541,222,56,12,154,319,55,0,0,55,264,0,0,264,"17031821401","821401"
"1043",795,134,0,0,0,0,134,0,0,0,0,134,19,0,115,661,314,95,0,219,347,132,33,0,99,215,12,11,192,"17031821402","821402"
"1044",819,360,8,0,0,8,352,50,0,0,50,302,54,27,221,459,91,27,4,60,368,34,4,4,26,334,25,15,294,"17031821500","821500"
"1045",1045,222,0,0,0,0,222,54,0,0,54,168,33,0,135,823,563,198,51,314,260,140,37,0,103,120,46,0,74,"17031821600","821600"
"1046",1209,57,0,0,0,0,57,0,0,0,0,57,15,0,42,1152,991,204,22,765,161,88,32,0,56,73,36,0,37,"17031821700","821700"
"1047",1420,131,93,0,0,93,38,0,0,0,0,38,0,0,38,1289,978,304,30,644,311,35,0,8,27,276,2,0,274,"17031821800","821800"
"1048",1274,219,44,0,0,44,175,0,0,0,0,175,92,0,83,1055,791,252,26,513,264,145,6,0,139,119,25,0,94,"17031821900","821900"
"1049",982,0,0,0,0,0,0,0,0,0,0,0,0,0,0,982,721,294,41,386,261,143,48,0,95,118,12,12,94,"17031822000","822000"
"1050",967,107,67,18,0,49,40,0,0,0,0,40,32,0,8,860,678,116,26,536,182,67,10,11,46,115,81,0,34,"17031822101","822101"
"1051",784,0,0,0,0,0,0,0,0,0,0,0,0,0,0,784,601,125,0,476,183,0,0,0,0,183,104,0,79,"17031822102","822102"
"1052",1094,336,157,0,24,133,179,0,0,0,0,179,34,0,145,758,701,130,64,507,57,6,6,0,0,51,0,0,51,"17031822200","822200"
"1053",963,11,0,0,0,0,11,0,0,0,0,11,11,0,0,952,786,192,87,507,166,15,0,0,15,151,32,0,119,"17031822301","822301"
"1054",964,231,86,34,7,45,145,0,0,0,0,145,0,11,134,733,557,164,0,393,176,11,0,0,11,165,0,0,165,"17031822302","822302"
"1055",1733,723,708,504,28,176,15,0,0,0,0,15,15,0,0,1010,837,279,43,515,173,49,23,0,26,124,29,0,95,"17031822400","822400"
"1056",830,0,0,0,0,0,0,0,0,0,0,0,0,0,0,830,687,174,78,435,143,32,9,0,23,111,17,0,94,"17031822500","822500"
"1057",919,176,84,0,0,84,92,0,0,0,0,92,11,0,81,743,587,210,17,360,156,26,0,0,26,130,0,0,130,"17031822601","822601"
"1058",1424,243,227,38,47,142,16,0,0,0,0,16,16,0,0,1181,1140,351,52,737,41,0,0,0,0,41,0,0,41,"17031822602","822602"
"1059",728,138,0,0,0,0,138,46,46,0,0,92,9,0,83,590,542,172,0,370,48,0,0,0,0,48,0,0,48,"17031822701","822701"
"1060",613,52,39,39,0,0,13,0,0,0,0,13,13,0,0,561,514,104,4,406,47,0,0,0,0,47,0,0,47,"17031822702","822702"
"1061",734,0,0,0,0,0,0,0,0,0,0,0,0,0,0,734,565,189,11,365,169,0,0,0,0,169,32,0,137,"17031822801","822801"
"1062",765,6,0,0,0,0,6,0,0,0,0,6,0,0,6,759,654,118,51,485,105,55,32,0,23,50,25,0,25,"17031822802","822802"
"1063",506,68,31,11,0,20,37,0,0,0,0,37,4,0,33,438,300,25,0,275,138,28,6,0,22,110,0,18,92,"17031822900","822900"
"1064",1280,208,97,0,0,97,111,54,54,0,0,57,19,18,20,1072,830,245,45,540,242,14,0,0,14,228,152,0,76,"17031823001","823001"
"1065",1503,226,148,91,0,57,78,0,0,0,0,78,63,0,15,1277,761,268,25,468,516,272,119,58,95,244,0,13,231,"17031823002","823002"
"1066",935,116,77,50,0,27,39,0,0,0,0,39,9,0,30,819,710,130,25,555,109,45,10,0,35,64,8,0,56,"17031823101","823101"
"1067",913,198,84,33,0,51,114,0,0,0,0,114,30,19,65,715,498,68,0,430,217,15,0,15,0,202,52,0,150,"17031823102","823102"
"1068",1025,98,70,13,0,57,28,0,0,0,0,28,28,0,0,927,813,155,19,639,114,7,0,0,7,107,0,0,107,"17031823200","823200"
"1069",1427,294,104,45,0,59,190,67,34,0,33,123,0,0,123,1133,804,321,107,376,329,126,0,0,126,203,96,4,103,"17031823302","823302"
"1070",1360,201,33,11,4,18,168,16,0,0,16,152,58,28,66,1159,927,267,61,599,232,46,20,0,26,186,0,0,186,"17031823303","823303"
"1071",1334,359,235,75,42,118,124,0,0,0,0,124,68,15,41,975,701,152,34,515,274,6,3,0,3,268,36,11,221,"17031823304","823304"
"1072",1135,418,137,29,8,100,281,75,8,19,48,206,55,0,151,717,519,115,38,366,198,44,0,0,44,154,52,13,89,"17031823400","823400"
"1073",1443,282,223,34,0,189,59,0,0,0,0,59,0,5,54,1161,1057,231,36,790,104,5,0,0,5,99,5,0,94,"17031823500","823500"
"1074",937,41,41,21,20,0,0,0,0,0,0,0,0,0,0,896,699,204,43,452,197,19,0,0,19,178,0,15,163,"17031823602","823602"
"1075",764,503,261,6,0,255,242,50,9,0,41,192,103,0,89,261,194,53,27,114,67,28,0,0,28,39,7,4,28,"17031823603","823603"
"1076",747,45,0,0,0,0,45,0,0,0,0,45,0,0,45,702,615,84,38,493,87,17,17,0,0,70,0,8,62,"17031823604","823604"
"1077",771,97,57,29,28,0,40,0,0,0,0,40,40,0,0,674,602,180,7,415,72,63,0,0,63,9,0,0,9,"17031823605","823605"
"1078",1502,355,355,78,63,214,0,0,0,0,0,0,0,0,0,1147,951,191,100,660,196,24,5,0,19,172,0,0,172,"17031823702","823702"
"1079",2244,578,396,50,0,346,182,0,0,0,0,182,0,13,169,1666,1205,391,68,746,461,186,150,0,36,275,0,0,275,"17031823703","823703"
"1080",811,188,176,30,17,129,12,0,0,0,0,12,0,0,12,623,530,153,25,352,93,8,8,0,0,85,42,0,43,"17031823704","823704"
"1081",1271,534,359,179,61,119,175,124,28,0,96,51,0,0,51,737,526,170,29,327,211,57,29,0,28,154,78,15,61,"17031823705","823705"
"1082",957,101,101,0,0,101,0,0,0,0,0,0,0,0,0,856,817,85,34,698,39,0,0,0,0,39,26,0,13,"17031823801","823801"
"1083",1301,280,190,27,0,163,90,0,0,0,0,90,19,0,71,1021,744,343,65,336,277,0,0,0,0,277,56,0,221,"17031823803","823803"
"1084",446,31,31,13,0,18,0,0,0,0,0,0,0,0,0,415,240,69,47,124,175,53,30,0,23,122,0,9,113,"17031823805","823805"
"1085",740,153,0,0,0,0,153,0,0,0,0,153,39,0,114,587,407,116,18,273,180,68,57,0,11,112,73,0,39,"17031823806","823806"
"1086",690,0,0,0,0,0,0,0,0,0,0,0,0,0,0,690,570,113,54,403,120,97,0,0,97,23,0,0,23,"17031823901","823901"
"1087",748,0,0,0,0,0,0,0,0,0,0,0,0,0,0,748,614,115,107,392,134,21,5,0,16,113,20,0,93,"17031823903","823903"
"1088",671,18,18,0,0,18,0,0,0,0,0,0,0,0,0,653,653,88,41,524,0,0,0,0,0,0,0,0,0,"17031823904","823904"
"1089",1332,0,0,0,0,0,0,0,0,0,0,0,0,0,0,1332,1332,229,95,1008,0,0,0,0,0,0,0,0,0,"17031824003","824003"
"1090",1120,39,22,0,0,22,17,0,0,0,0,17,0,0,17,1081,1072,186,22,864,9,9,0,0,9,0,0,0,0,"17031824004","824004"
"1091",1444,22,22,0,0,22,0,0,0,0,0,0,0,0,0,1422,1314,241,31,1042,108,63,14,0,49,45,0,11,34,"17031824005","824005"
"1092",1057,76,0,0,0,0,76,0,0,0,0,76,19,18,39,981,972,144,61,767,9,0,0,0,0,9,0,0,9,"17031824006","824006"
"1093",1254,41,16,16,0,0,25,0,0,0,0,25,0,0,25,1213,1052,173,15,864,161,11,0,0,11,150,0,0,150,"17031824105","824105"
"1094",1515,112,0,0,0,0,112,30,0,0,30,82,71,0,11,1403,1142,408,46,688,261,10,10,0,0,251,42,0,209,"17031824106","824106"
"1095",969,132,104,0,0,104,28,0,0,0,0,28,0,0,28,837,755,105,20,630,82,0,0,0,0,82,16,0,66,"17031824107","824107"
"1096",1819,126,67,0,0,67,59,0,0,0,0,59,15,0,44,1693,1442,338,84,1020,251,69,0,0,69,182,0,0,182,"17031824108","824108"
"1097",1694,126,126,14,13,99,0,0,0,0,0,0,0,0,0,1568,1424,299,49,1076,144,28,0,0,28,116,16,0,100,"17031824113","824113"
"1098",1240,235,235,32,0,203,0,0,0,0,0,0,0,0,0,1005,727,233,44,450,278,95,0,0,95,183,45,0,138,"17031824114","824114"
"1099",465,59,0,0,0,0,59,0,0,0,0,59,0,0,59,406,381,77,8,296,25,10,10,0,0,15,0,0,15,"17031824115","824115"
"1100",1069,117,0,0,0,0,117,0,0,0,0,117,7,0,110,952,598,288,0,310,354,82,0,0,82,272,37,0,235,"17031824116","824116"
"1101",2239,0,0,0,0,0,0,0,0,0,0,0,0,0,0,2239,2030,596,165,1269,209,65,20,0,45,144,0,0,144,"17031824117","824117"
"1102",1359,80,0,0,0,0,80,0,0,0,0,80,23,0,57,1279,1227,199,31,997,52,16,0,0,16,36,0,0,36,"17031824119","824119"
"1103",1889,143,86,72,0,14,57,57,57,0,0,0,0,0,0,1746,1662,239,24,1399,84,0,0,0,0,84,25,0,59,"17031824120","824120"
"1104",754,83,83,8,16,59,0,0,0,0,0,0,0,0,0,671,596,145,42,409,75,42,34,8,0,33,10,12,11,"17031824121","824121"
"1105",1226,123,16,0,0,16,107,0,0,0,0,107,40,0,67,1103,940,280,31,629,163,0,0,0,0,163,30,0,133,"17031824122","824122"
"1106",2271,73,0,0,0,0,73,0,0,0,0,73,0,0,73,2198,1786,565,79,1142,412,18,18,0,0,394,57,61,276,"17031824123","824123"
"1107",1046,448,58,0,20,38,390,30,15,5,10,360,87,50,223,598,325,76,5,244,273,59,0,0,59,214,0,0,214,"17031824300","824300"
"1108",553,117,64,7,21,36,53,0,0,0,0,53,0,0,53,436,199,39,0,160,237,64,10,0,54,173,63,0,110,"17031824400","824400"
"1109",1104,0,0,0,0,0,0,0,0,0,0,0,0,0,0,1104,988,291,25,672,116,0,0,0,0,116,0,0,116,"17031824503","824503"
"1110",2000,104,54,0,0,54,50,0,0,0,0,50,0,0,50,1896,1496,336,145,1015,400,90,47,0,43,310,200,0,110,"17031824505","824505"
"1111",1509,191,81,0,0,81,110,0,0,0,0,110,55,55,0,1318,865,210,63,592,453,166,41,37,88,287,60,15,212,"17031824506","824506"
"1112",844,30,0,0,0,0,30,0,0,0,0,30,7,0,23,814,755,220,42,493,59,45,15,8,22,14,0,0,14,"17031824507","824507"
"1113",1041,39,20,14,0,6,19,19,19,0,0,0,0,0,0,1002,786,126,53,607,216,18,0,0,18,198,25,0,173,"17031824601","824601"
"1114",1629,214,0,0,0,0,214,0,0,0,0,214,62,0,152,1415,1082,386,72,624,333,12,12,0,0,321,37,44,240,"17031824602","824602"
"1115",916,10,0,0,0,0,10,0,0,0,0,10,0,0,10,906,756,254,28,474,150,138,113,0,25,12,0,0,12,"17031824701","824701"
"1116",1425,468,210,99,11,100,258,0,0,0,0,258,87,0,171,957,686,266,58,362,271,70,10,0,60,201,21,28,152,"17031824702","824702"
"1117",2631,746,113,17,0,96,633,349,0,0,349,284,70,0,214,1885,1079,332,24,723,806,293,151,26,116,513,150,0,363,"17031824800","824800"
"1118",717,134,91,16,0,75,43,0,0,0,0,43,0,0,43,583,505,73,26,406,78,0,0,0,0,78,22,0,56,"17031824900","824900"
"1119",1188,139,0,0,0,0,139,11,11,0,0,128,91,0,37,1049,875,284,62,529,174,58,34,0,24,116,6,0,110,"17031825000","825000"
"1120",430,73,15,0,0,15,58,0,0,0,0,58,58,0,0,357,295,26,23,246,62,32,23,4,5,30,18,6,6,"17031825200","825200"
"1121",1377,381,305,183,122,0,76,0,0,0,0,76,76,0,0,996,910,243,45,622,86,44,0,0,44,42,0,0,42,"17031825302","825302"
"1122",989,365,0,0,0,0,365,304,86,41,177,61,10,0,51,624,522,401,13,108,102,30,0,0,30,72,36,0,36,"17031825303","825303"
"1123",853,75,46,32,0,14,29,29,29,0,0,0,0,0,0,778,647,94,36,517,131,63,0,0,63,68,22,0,46,"17031825304","825304"
"1124",1137,40,0,0,0,0,40,0,0,0,0,40,0,0,40,1097,808,227,21,560,289,39,0,0,39,250,25,0,225,"17031825400","825400"
"1125",1835,531,86,21,20,45,445,61,0,0,61,384,75,34,275,1304,872,175,78,619,432,68,28,0,40,364,93,6,265,"17031825501","825501"
"1126",1802,739,263,0,0,263,476,0,0,0,0,476,82,33,361,1063,295,47,0,248,768,10,0,0,10,758,117,82,559,"17031825503","825503"
"1127",1124,282,41,21,10,10,241,0,0,0,0,241,58,0,183,842,616,83,56,477,226,28,0,0,28,198,80,6,112,"17031825504","825504"
"1128",1139,272,165,49,0,116,107,0,0,0,0,107,0,0,107,867,369,96,7,266,498,118,12,0,106,380,139,0,241,"17031825505","825505"
"1129",1463,407,44,11,0,33,363,56,20,0,36,307,68,65,174,1056,560,62,49,449,496,96,0,0,96,400,67,3,330,"17031825600","825600"
"1130",947,244,10,0,0,10,234,71,48,0,23,163,0,0,163,703,320,63,5,252,383,85,6,12,67,298,80,19,199,"17031825700","825700"
"1131",920,460,155,0,0,155,305,35,0,0,35,270,38,34,198,460,133,19,0,114,327,104,53,21,30,223,77,0,146,"17031825801","825801"
"1132",1179,361,100,0,0,100,261,0,0,0,0,261,36,0,225,818,444,0,16,428,374,56,0,0,56,318,58,6,254,"17031825802","825802"
"1133",890,174,104,36,0,68,70,0,0,0,0,70,0,14,56,716,270,26,0,244,446,158,82,0,76,288,49,56,183,"17031825803","825803"
"1134",1022,393,32,32,0,0,361,50,50,0,0,311,47,0,264,629,360,85,15,260,269,14,0,0,14,255,56,2,197,"17031825900","825900"
"1135",1321,740,138,0,0,138,602,201,44,22,135,401,39,31,331,581,229,39,15,175,352,125,59,0,66,227,78,0,149,"17031826000","826000"
"1136",2569,777,586,143,0,443,191,0,0,0,0,191,26,0,165,1792,1056,132,0,924,736,183,18,0,165,553,113,42,398,"17031826100","826100"
"1137",675,218,101,0,0,101,117,0,0,0,0,117,78,20,19,457,205,17,20,168,252,8,0,0,8,244,62,41,141,"17031826201","826201"
"1138",1836,566,128,44,0,84,438,102,0,34,68,336,54,0,282,1270,549,150,49,350,721,308,83,0,225,413,9,15,389,"17031826202","826202"
"1139",955,22,0,0,0,0,22,22,0,0,22,0,0,0,0,933,714,226,46,442,219,27,0,0,27,192,43,0,149,"17031826301","826301"
"1140",1128,223,0,0,0,0,223,0,0,0,0,223,32,9,182,905,635,80,17,538,270,58,0,0,58,212,60,0,152,"17031826303","826303"
"1141",662,110,0,0,0,0,110,18,18,0,0,92,45,0,47,552,247,10,67,170,305,66,0,0,66,239,67,30,142,"17031826304","826304"
"1142",1246,220,67,0,0,67,153,11,0,0,11,142,17,0,125,1026,374,80,0,294,652,325,125,30,170,327,22,0,305,"17031826401","826401"
"1143",1259,481,27,0,0,27,454,9,0,0,9,445,64,58,323,778,336,86,0,250,442,41,23,0,18,401,90,25,286,"17031826402","826402"
"1144",1885,1110,92,22,0,70,1018,151,78,0,73,867,148,34,685,775,353,30,10,313,422,93,0,0,93,329,65,0,264,"17031826500","826500"
"1145",1432,558,64,0,0,64,494,60,31,0,29,434,156,25,253,874,397,61,65,271,477,5,5,0,0,472,111,25,336,"17031826600","826600"
"1146",1386,253,37,0,0,37,216,0,0,0,0,216,69,51,96,1133,523,244,16,263,610,58,0,0,58,552,28,0,524,"17031826700","826700"
"1147",1651,781,331,120,38,173,450,260,20,0,240,190,105,42,43,870,612,303,17,292,258,14,0,0,14,244,42,0,202,"17031826800","826800"
"1148",288,99,0,0,0,0,99,0,0,0,0,99,28,0,71,189,78,46,0,32,111,0,0,0,0,111,19,0,92,"17031826901","826901"
"1149",151,84,0,0,0,0,84,0,0,0,0,84,19,0,65,67,5,0,0,5,62,3,0,0,3,59,31,0,28,"17031826902","826902"
"1150",1192,661,86,26,12,48,575,0,0,0,0,575,209,13,353,531,215,28,0,187,316,54,0,0,54,262,87,0,175,"17031827000","827000"
"1151",858,422,80,37,0,43,342,14,0,0,14,328,48,28,252,436,218,67,0,151,218,73,1,0,72,145,91,0,54,"17031827100","827100"
"1152",1199,486,49,14,4,31,437,57,20,0,37,380,74,33,273,713,468,184,49,235,245,5,0,0,5,240,41,0,199,"17031827200","827200"
"1153",1078,581,39,30,0,9,542,65,65,0,0,477,198,33,246,497,129,0,0,129,368,31,11,10,10,337,205,0,132,"17031827300","827300"
"1154",1139,539,127,101,0,26,412,0,0,0,0,412,126,65,221,600,277,28,39,210,323,0,0,0,0,323,115,0,208,"17031827400","827400"
"1155",1627,759,178,79,51,48,581,79,35,0,44,502,62,0,440,868,563,208,29,326,305,118,0,0,118,187,73,0,114,"17031827500","827500"
"1156",944,498,85,0,0,85,413,165,98,0,67,248,66,0,182,446,213,55,0,158,233,74,0,7,67,159,0,0,159,"17031827600","827600"
"1157",939,350,186,64,82,40,164,0,0,0,0,164,57,0,107,589,264,88,17,159,325,83,0,17,66,242,19,5,218,"17031827700","827700"
"1158",1137,105,22,22,0,0,83,0,0,0,0,83,0,0,83,1032,884,88,85,711,148,67,0,31,36,81,11,0,70,"17031827801","827801"
"1159",937,92,0,0,0,0,92,40,0,0,40,52,0,0,52,845,390,112,11,267,455,135,0,0,135,320,30,0,290,"17031827802","827802"
"1160",583,0,0,0,0,0,0,0,0,0,0,0,0,0,0,583,327,24,10,293,256,18,0,0,18,238,37,0,201,"17031827804","827804"
"1161",572,82,6,0,0,6,76,0,0,0,0,76,0,0,76,490,352,49,0,303,138,0,0,0,0,138,54,17,67,"17031827805","827805"
"1162",362,0,0,0,0,0,0,0,0,0,0,0,0,0,0,362,154,36,0,118,208,74,0,0,74,134,52,0,82,"17031827901","827901"
"1163",1033,216,146,33,0,113,70,0,0,0,0,70,34,12,24,817,554,220,47,287,263,52,0,0,52,211,39,17,155,"17031827902","827902"
"1164",1156,157,15,7,0,8,142,0,0,0,0,142,29,0,113,999,638,129,5,504,361,82,34,0,48,279,22,12,245,"17031828000","828000"
"1165",944,90,0,0,0,0,90,19,0,0,19,71,54,0,17,854,679,82,0,597,175,19,0,0,19,156,75,0,81,"17031828100","828100"
"1166",1156,257,57,57,0,0,200,34,0,0,34,166,42,0,124,899,608,207,20,381,291,20,20,0,0,271,61,0,210,"17031828201","828201"
"1167",1021,148,60,42,0,18,88,50,26,24,0,38,0,0,38,873,648,153,7,488,225,16,0,0,16,209,15,0,194,"17031828202","828202"
"1168",716,55,22,0,0,22,33,8,8,0,0,25,0,9,16,661,400,143,20,237,261,20,6,0,14,241,74,0,167,"17031828300","828300"
"1169",896,63,28,9,0,19,35,0,0,0,0,35,0,0,35,833,624,132,51,441,209,110,0,0,110,99,20,0,79,"17031828401","828401"
"1170",764,97,23,8,5,10,74,0,0,0,0,74,4,0,70,667,339,61,37,241,328,46,0,0,46,282,57,44,181,"17031828402","828402"
"1171",1246,431,16,0,0,16,415,11,0,0,11,404,79,30,295,815,330,147,0,183,485,115,0,0,115,370,67,23,280,"17031828503","828503"
"1172",2223,844,170,13,6,151,674,35,0,0,35,639,56,0,583,1379,752,140,45,567,627,114,31,5,78,513,111,18,384,"17031828504","828504"
"1173",1620,367,18,0,0,18,349,0,0,0,0,349,47,0,302,1253,866,158,75,633,387,26,0,0,26,361,12,14,335,"17031828505","828505"
"1174",2619,1080,348,120,16,212,732,137,23,25,89,595,240,41,314,1539,1101,371,88,642,438,14,0,0,14,424,85,0,339,"17031828506","828506"
"1175",857,67,58,9,10,39,9,0,0,0,0,9,0,0,9,790,650,136,67,447,140,23,0,0,23,117,0,0,117,"17031828601","828601"
"1176",1320,75,0,0,0,0,75,0,0,0,0,75,10,0,65,1245,999,221,37,741,246,89,61,28,0,157,0,0,157,"17031828602","828602"
"1177",750,27,0,0,0,0,27,0,0,0,0,27,13,0,14,723,387,105,35,247,336,18,0,0,18,318,159,50,109,"17031828701","828701"
"1178",1509,270,74,0,10,64,196,0,0,0,0,196,57,20,119,1239,843,311,7,525,396,46,9,0,37,350,55,0,295,"17031828702","828702"
"1179",1300,237,177,83,0,94,60,0,0,0,0,60,0,0,60,1063,847,211,0,636,216,18,0,0,18,198,33,0,165,"17031828801","828801"
"1180",707,139,114,8,0,106,25,16,0,0,16,9,0,0,9,568,388,75,11,302,180,65,0,0,65,115,21,0,94,"17031828802","828802"
"1181",1235,557,100,35,33,32,457,150,30,15,105,307,110,11,186,678,352,144,16,192,326,101,46,19,36,225,83,13,129,"17031828900","828900"
"1182",633,576,70,21,0,49,506,34,20,14,0,472,187,10,275,57,0,0,0,0,57,0,0,0,0,57,0,0,57,"17031829000","829000"
"1183",1347,585,372,70,52,250,213,24,24,0,0,189,97,0,92,762,433,152,21,260,329,111,67,0,44,218,82,0,136,"17031829100","829100"
"1184",1737,432,91,0,30,61,341,46,0,0,46,295,32,0,263,1305,871,221,0,650,434,185,23,0,162,249,26,0,223,"17031829200","829200"
"1185",663,156,0,0,0,0,156,0,0,0,0,156,0,0,156,507,354,91,0,263,153,22,7,0,15,131,19,0,112,"17031829301","829301"
"1186",1240,723,226,29,14,183,497,20,0,0,20,477,113,23,341,517,383,68,18,297,134,25,25,0,0,109,78,0,31,"17031829302","829302"
"1187",524,394,65,14,0,51,329,24,0,0,24,305,76,7,222,130,6,0,0,6,124,0,0,0,0,124,51,0,73,"17031829401","829401"
"1188",894,287,71,17,0,54,216,0,0,0,0,216,64,46,106,607,197,110,13,74,410,164,48,0,116,246,85,0,161,"17031829402","829402"
"1189",1138,245,21,14,7,0,224,7,0,0,7,217,61,43,113,893,564,112,40,412,329,38,0,26,12,291,75,0,216,"17031829500","829500"
"1190",769,89,89,8,0,81,0,0,0,0,0,0,0,0,0,680,609,201,64,344,71,27,0,0,27,44,23,0,21,"17031829600","829600"
"1191",1080,596,50,17,0,33,546,41,0,0,41,505,106,63,336,484,350,19,0,331,134,15,15,0,0,119,41,8,70,"17031829700","829700"
"1192",1798,38,0,0,0,0,38,0,0,0,0,38,0,0,38,1760,1311,154,64,1093,449,30,0,0,30,419,0,0,419,"17031829800","829800"
"1193",1978,105,52,0,0,52,53,0,0,0,0,53,0,0,53,1873,1328,282,97,949,545,0,0,0,0,545,275,8,262,"17031829901","829901"
"1194",1426,48,0,0,0,0,48,0,0,0,0,48,0,0,48,1378,875,106,0,769,503,92,40,0,52,411,163,62,186,"17031829902","829902"
"1195",25,0,0,0,0,0,0,0,0,0,0,0,0,0,0,25,7,7,0,0,18,0,0,0,0,18,0,9,9,"17031830001","830001"
"1196",2446,736,192,42,0,150,544,0,0,0,0,544,134,67,343,1710,1306,456,15,835,404,44,0,0,44,360,41,0,319,"17031830003","830003"
"1197",1561,208,0,0,0,0,208,0,0,0,0,208,0,42,166,1353,1205,201,26,978,148,57,0,0,57,91,46,0,45,"17031830004","830004"
"1198",653,37,0,0,0,0,37,0,0,0,0,37,0,0,37,616,385,115,18,252,231,0,0,0,0,231,0,0,231,"17031830005","830005"
"1199",671,21,0,0,0,0,21,0,0,0,0,21,0,0,21,650,370,74,24,272,280,192,90,0,102,88,21,0,67,"17031830006","830006"
"1200",820,323,0,0,0,0,323,10,0,0,10,313,113,26,174,497,262,81,16,165,235,0,0,0,0,235,15,0,220,"17031830007","830007"
"1201",1175,75,0,0,0,0,75,31,0,0,31,44,0,0,44,1100,645,210,38,397,455,26,0,0,26,429,58,0,371,"17031830008","830008"
"1202",846,248,103,23,0,80,145,0,0,0,0,145,19,0,126,598,277,17,25,235,321,0,0,0,0,321,105,0,216,"17031830100","830100"
"1203",1170,196,71,0,20,51,125,0,0,0,0,125,36,40,49,974,415,88,30,297,559,79,0,0,79,480,109,37,334,"17031830201","830201"
"1204",888,274,0,0,0,0,274,0,0,0,0,274,111,0,163,614,376,102,11,263,238,50,24,0,26,188,45,0,143,"17031830202","830202"
"1205",1382,245,0,0,0,0,245,0,0,0,0,245,87,41,117,1137,655,101,80,474,482,58,18,0,40,424,12,65,347,"17031830300","830300"
"1206",1123,273,42,0,0,42,231,0,0,0,0,231,64,41,126,850,416,120,14,282,434,52,0,0,52,382,38,48,296,"17031830400","830400"
"1207",1280,464,322,68,12,242,142,7,7,0,0,135,22,0,113,816,575,101,0,474,241,178,32,25,121,63,59,0,4,"17031830500","830500"
"1208",1292,563,292,66,8,218,271,34,0,15,19,237,149,22,66,729,443,224,40,179,286,98,43,0,55,188,34,37,117,"17031830600","830600"
"1209",410,177,90,0,30,60,87,0,0,0,0,87,16,8,63,233,146,73,0,73,87,9,9,0,0,78,0,0,78,"17031830700","830700"
"1210",315,0,0,0,0,0,0,0,0,0,0,0,0,0,0,315,289,176,40,73,26,0,0,0,0,26,0,0,26,"17031830800","830800"
"1211",537,76,54,28,26,0,22,0,0,0,0,22,0,11,11,461,304,211,40,53,157,22,22,0,0,135,20,0,115,"17031830900","830900"
"1212",380,0,0,0,0,0,0,0,0,0,0,0,0,0,0,380,361,224,0,137,19,0,0,0,0,19,4,0,15,"17031831000","831000"
"1213",2161,418,196,63,39,94,222,49,13,36,0,173,11,0,162,1743,1286,331,13,942,457,262,140,110,12,195,91,73,31,"17031831100","831100"
"1214",1478,460,248,71,9,168,212,0,0,0,0,212,82,16,114,1018,633,107,42,484,385,258,90,20,148,127,9,17,101,"17031831200","831200"
"1215",396,167,37,8,0,29,130,72,37,0,35,58,58,0,0,229,186,0,18,168,43,0,0,0,0,43,19,6,18,"17031831300","831300"
"1216",498,187,0,0,0,0,187,54,22,0,32,133,24,0,109,311,18,18,0,0,293,41,0,0,41,252,76,0,176,"17031831400","831400"
"1217",1107,114,0,0,0,0,114,0,0,0,0,114,77,25,12,993,830,184,69,577,163,69,15,16,38,94,23,21,50,"17031831500","831500"
"1218",1402,279,173,61,0,112,106,31,31,0,0,75,11,0,64,1123,784,175,48,561,339,54,32,0,22,285,84,11,190,"17031831600","831600"
"1219",527,65,15,5,0,10,50,0,0,0,0,50,16,0,34,462,296,50,31,215,166,96,28,0,68,70,19,0,51,"17031831700","831700"
"1220",1481,318,300,215,0,85,18,0,0,0,0,18,0,0,18,1163,821,356,14,451,342,83,25,0,58,259,58,0,201,"17031831800","831800"
"1221",290,0,0,0,0,0,0,0,0,0,0,0,0,0,0,290,290,144,5,141,0,0,0,0,0,0,0,0,0,"17031831900","831900"
"1222",221,44,44,44,0,0,0,0,0,0,0,0,0,0,0,177,171,143,28,0,6,6,0,0,6,0,0,0,0,"17031832000","832000"
"1223",327,120,0,0,0,0,120,0,0,0,0,120,0,0,120,207,167,111,16,40,40,8,0,0,8,32,0,0,32,"17031832100","832100"
"1224",474,0,0,0,0,0,0,0,0,0,0,0,0,0,0,474,447,145,68,234,27,0,0,0,0,27,0,0,27,"17031832200","832200"
"1225",458,4,4,4,0,0,0,0,0,0,0,0,0,0,0,454,445,253,20,172,9,0,0,0,0,9,0,0,9,"17031832300","832300"
"1226",664,279,256,55,27,174,23,0,0,0,0,23,8,0,15,385,283,165,23,95,102,88,48,0,40,14,10,0,4,"17031832400","832400"
"1227",704,198,0,0,0,0,198,0,0,0,0,198,0,15,183,506,391,139,41,211,115,0,0,0,0,115,63,0,52,"17031832500","832500"
"1228",728,111,70,30,0,40,41,0,0,0,0,41,0,0,41,617,554,252,11,291,63,44,0,0,44,19,0,0,19,"17031832600","832600"
"1229",307,72,72,49,0,23,0,0,0,0,0,0,0,0,0,235,190,134,25,31,45,0,0,0,0,45,0,0,45,"17031832900","832900"
"1230",190,0,0,0,0,0,0,0,0,0,0,0,0,0,0,190,190,110,6,74,0,0,0,0,0,0,0,0,0,"17031833000","833000"
"1231",570,156,0,0,0,0,156,0,0,0,0,156,43,0,113,414,323,217,0,106,91,0,0,0,0,91,0,14,77,"17031833100","833100"
"1232",194,11,0,0,0,0,11,0,0,0,0,11,0,0,11,183,155,25,0,130,28,0,0,0,0,28,5,0,23,"17031833300","833300"
"1233",779,496,144,65,0,79,352,58,0,0,58,294,168,4,122,283,169,56,0,113,114,31,0,0,31,83,8,0,75,"17031833900","833900"
"1234",1223,277,0,0,0,0,277,0,0,0,0,277,15,6,256,946,295,28,0,267,651,69,0,34,35,582,72,13,497,"17031834000","834000"
"1235",1066,569,0,0,0,0,569,35,0,0,35,534,324,17,193,497,206,37,36,133,291,59,14,0,45,232,54,0,178,"17031834200","834200"
"1236",1134,372,105,54,0,51,267,11,0,0,11,256,57,27,172,762,283,58,15,210,479,114,0,0,114,365,55,19,291,"17031834300","834300"
"1237",1201,343,43,0,0,43,300,19,0,0,19,281,70,0,211,858,252,88,38,126,606,0,0,0,0,606,99,66,441,"17031834400","834400"
"1238",723,447,40,10,0,30,407,54,27,0,27,353,82,32,239,276,46,0,0,46,230,2,0,0,2,228,90,0,138,"17031834500","834500"
"1239",894,460,0,0,0,0,460,37,19,0,18,423,178,0,245,434,0,0,0,0,434,58,16,0,42,376,72,22,282,"17031834600","834600"
"1240",485,343,42,0,0,42,301,18,0,0,18,283,106,21,156,142,36,0,0,36,106,50,0,0,50,56,8,0,48,"17031834700","834700"
"1241",462,298,37,20,0,17,261,0,0,0,0,261,151,12,98,164,24,0,0,24,140,0,0,0,0,140,15,0,125,"17031834800","834800"
"1242",735,511,0,0,0,0,511,45,28,13,4,466,116,24,326,224,65,25,10,30,159,0,0,0,0,159,64,0,95,"17031834900","834900"
"1243",1873,1057,141,8,8,125,916,95,48,17,30,821,307,25,489,816,398,116,0,282,418,102,45,0,57,316,31,0,285,"17031835000","835000"
"1244",1830,448,431,113,21,297,17,0,0,0,0,17,0,0,17,1382,969,274,48,647,413,245,43,0,202,168,8,30,130,"17031835100","835100"
"1245",407,85,47,18,0,29,38,0,0,0,0,38,14,12,12,322,267,58,4,205,55,0,0,0,0,55,4,13,38,"17031835200","835200"
"1246",369,94,15,0,10,5,79,0,0,0,0,79,0,26,53,275,93,41,0,52,182,6,0,0,6,176,63,0,113,"17031835500","835500"
"1247",301,156,18,18,0,0,138,0,0,0,0,138,19,0,119,145,41,16,0,25,104,16,11,3,2,88,12,0,76,"17031835600","835600"
"1248",69,69,0,0,0,0,69,59,0,0,59,10,0,0,10,0,0,0,0,0,0,0,0,0,0,0,0,0,0,"17031835700","835700"
"1249",289,179,0,0,0,0,179,0,0,0,0,179,61,33,85,110,37,37,0,0,73,0,0,0,0,73,33,0,40,"17031835800","835800"
"1250",920,648,0,0,0,0,648,20,0,0,20,628,168,8,452,272,84,8,0,76,188,38,6,0,32,150,68,15,67,"17031835900","835900"
"1251",742,424,14,14,0,0,410,0,0,0,0,410,52,12,346,318,166,122,0,44,152,0,0,0,0,152,12,0,140,"17031836000","836000"
"1252",466,216,22,4,0,18,194,28,8,0,20,166,48,0,118,250,69,40,9,20,181,9,0,0,9,172,0,0,172,"17031836100","836100"
"1253",72,0,0,0,0,0,0,0,0,0,0,0,0,0,0,72,69,61,4,4,3,3,0,0,3,0,0,0,0,"17031836200","836200"
"1254",257,5,0,0,0,0,5,0,0,0,0,5,0,0,5,252,158,70,0,88,94,18,0,5,13,76,0,16,60,"17031836300","836300"
"1255",810,250,37,37,0,0,213,0,0,0,0,213,45,24,144,560,267,94,19,154,293,29,0,0,29,264,39,39,186,"17031836400","836400"
"1256",599,311,3,0,0,3,308,0,0,0,0,308,141,72,95,288,129,6,0,123,159,0,0,0,0,159,32,0,127,"17031836500","836500"
"1257",609,243,88,46,21,21,155,24,24,0,0,131,7,9,115,366,225,72,2,151,141,21,0,0,21,120,25,0,95,"17031836600","836600"
"1258",897,437,0,0,0,0,437,0,0,0,0,437,141,39,257,460,201,73,23,105,259,0,0,0,0,259,53,0,206,"17031836700","836700"
"1259",708,497,0,0,0,0,497,0,0,0,0,497,219,0,278,211,18,18,0,0,193,16,0,0,16,177,46,24,107,"17031836800","836800"
"1260",586,302,0,0,0,0,302,88,20,19,49,214,22,26,166,284,105,30,0,75,179,0,0,0,0,179,36,5,138,"17031836900","836900"
"1261",702,235,80,0,16,64,155,0,0,0,0,155,44,7,104,467,130,54,5,71,337,108,69,28,11,229,0,0,229,"17031837000","837000"
"1262",481,171,52,32,0,20,119,0,0,0,0,119,64,0,55,310,139,73,28,38,171,76,0,0,76,95,0,0,95,"17031837100","837100"
"1263",651,358,110,0,0,110,248,5,0,0,5,243,77,36,130,293,26,0,0,26,267,20,0,0,20,247,51,17,179,"17031837300","837300"
"1264",623,337,0,0,0,0,337,32,0,0,32,305,100,0,205,286,132,31,0,101,154,28,10,0,18,126,28,12,86,"17031837400","837400"
"1265",903,385,18,0,0,18,367,49,14,0,35,318,121,15,182,518,387,99,11,277,131,35,35,0,0,96,11,0,85,"17031837800","837800"
"1266",901,592,0,0,0,0,592,182,27,0,155,410,43,33,334,309,192,46,4,142,117,0,0,0,0,117,27,0,90,"17031838000","838000"
"1267",193,12,0,0,0,0,12,0,0,0,0,12,0,0,12,181,114,57,0,57,67,0,0,0,0,67,15,0,52,"17031838100","838100"
"1268",88,5,0,0,0,0,5,0,0,0,0,5,5,0,0,83,33,27,0,6,50,0,0,0,0,50,3,5,42,"17031838200","838200"
"1269",228,109,7,7,0,0,102,0,0,0,0,102,52,6,44,119,52,10,0,42,67,0,0,0,0,67,0,0,67,"17031838300","838300"
"1270",820,460,0,0,0,0,460,0,0,0,0,460,167,15,278,360,42,0,0,42,318,3,0,0,3,315,44,36,235,"17031838600","838600"
"1271",1630,830,113,20,19,74,717,0,0,0,0,717,188,21,508,800,300,59,0,241,500,53,17,0,36,447,96,7,344,"17031838700","838700"
"1272",1208,848,75,42,0,33,773,69,0,18,51,704,109,31,564,360,135,37,0,98,225,0,0,0,0,225,0,0,225,"17031838800","838800"
"1273",734,0,0,0,0,0,0,0,0,0,0,0,0,0,0,734,672,447,16,209,62,0,0,0,0,62,0,62,0,"17031839000","839000"
"1274",269,87,40,0,0,40,47,0,0,0,0,47,33,14,0,182,182,66,2,114,0,0,0,0,0,0,0,0,0,"17031839100","839100"
"1275",243,30,5,0,0,5,25,0,0,0,0,25,0,0,25,213,20,12,0,8,193,0,0,0,0,193,17,0,176,"17031839200","839200"
"1276",253,73,0,0,0,0,73,0,0,0,0,73,30,0,43,180,156,10,20,126,24,0,0,0,0,24,0,0,24,"17031839500","839500"
"1277",258,53,0,0,0,0,53,0,0,0,0,53,0,0,53,205,90,23,0,67,115,0,0,0,0,115,4,8,103,"17031839600","839600"
"1278",1374,685,23,12,0,11,662,131,0,0,131,531,180,52,299,689,412,86,26,300,277,186,38,0,148,91,45,6,40,"17031839700","839700"
"1279",426,114,72,39,0,33,42,24,0,0,24,18,0,0,18,312,232,63,9,160,80,15,15,0,0,65,10,0,55,"17031839800","839800"
"1280",690,163,43,43,0,0,120,9,0,0,9,111,18,0,93,527,436,159,30,247,91,13,0,0,13,78,7,19,52,"17031839900","839900"
"1281",464,102,68,0,0,68,34,0,0,0,0,34,12,0,22,362,301,201,4,96,61,7,0,0,7,54,7,0,47,"17031840000","840000"
"1282",745,355,283,4,4,275,72,18,0,0,18,54,10,0,44,390,277,41,0,236,113,34,0,0,34,79,0,6,73,"17031840100","840100"
"1283",518,82,30,10,0,20,52,22,0,0,22,30,5,0,25,436,365,95,31,239,71,21,0,0,21,50,15,5,30,"17031840200","840200"
"1284",1164,488,305,103,29,173,183,33,0,23,10,150,47,11,92,676,448,150,21,277,228,5,0,0,5,223,59,15,149,"17031840300","840300"
"1285",739,364,130,23,27,80,234,61,0,0,61,173,13,32,128,375,301,87,9,205,74,0,0,0,0,74,43,12,19,"17031840400","840400"
"1286",1281,872,295,95,24,176,577,76,0,19,57,501,53,28,420,409,306,165,0,141,103,62,28,7,27,41,0,0,41,"17031840700","840700"
"1287",1387,628,214,26,0,188,414,21,0,0,21,393,86,53,254,759,522,160,23,339,237,86,44,0,42,151,34,0,117,"17031840800","840800"
"1288",108,54,17,9,0,8,37,0,0,0,0,37,27,0,10,54,22,12,0,10,32,0,0,0,0,32,22,1,9,"17031841000","841000"
"1289",1269,580,416,115,32,269,164,39,39,0,0,125,0,0,125,689,581,60,0,521,108,0,0,0,0,108,0,10,98,"17031841100","841100"
"1290",1843,782,219,61,0,158,563,142,0,10,132,421,132,18,271,1061,692,159,14,519,369,128,52,19,57,241,45,19,177,"17031841200","841200"
"1291",1301,478,209,49,0,160,269,115,60,0,55,154,39,40,75,823,580,117,20,443,243,46,19,12,15,197,53,0,144,"17031841300","841300"
"1292",500,400,19,0,0,19,381,16,16,0,0,365,94,21,250,100,51,51,0,0,49,0,0,0,0,49,0,6,43,"17031841400","841400"
"1293",1076,655,120,20,12,88,535,61,19,0,42,474,136,55,283,421,47,24,0,23,374,0,0,0,0,374,110,18,246,"17031841500","841500"
"1294",197,112,5,5,0,0,107,0,0,0,0,107,43,4,60,85,9,0,0,9,76,0,0,0,0,76,0,0,76,"17031841600","841600"
"1295",216,134,57,6,0,51,77,0,0,0,0,77,12,0,65,82,53,0,0,53,29,0,0,0,0,29,19,0,10,"17031841700","841700"
"1296",681,291,0,0,0,0,291,18,0,0,18,273,115,12,146,390,30,4,0,26,360,0,0,0,0,360,78,0,282,"17031841800","841800"
"1297",482,132,22,22,0,0,110,110,29,27,54,0,0,0,0,350,296,173,23,100,54,20,0,0,20,34,8,7,19,"17031841900","841900"
"1298",112,33,33,0,0,33,0,0,0,0,0,0,0,0,0,79,67,27,3,37,12,0,0,0,0,12,0,3,9,"17031842000","842000"
"1299",1829,1248,146,14,34,98,1102,125,44,0,81,977,292,0,685,581,394,77,0,317,187,104,38,40,26,83,25,0,58,"17031842100","842100"
"1300",245,124,0,0,0,0,124,0,0,0,0,124,6,32,86,121,77,77,0,0,44,0,0,0,0,44,30,0,14,"17031842200","842200"
"1301",360,72,64,64,0,0,8,0,0,0,0,8,0,0,8,288,252,114,21,117,36,6,0,0,6,30,0,0,30,"17031842300","842300"
"1302",785,363,61,61,0,0,302,15,15,0,0,287,111,43,133,422,98,26,0,72,324,19,0,0,19,305,65,0,240,"17031842400","842400"
"1303",1323,1167,0,0,0,0,1167,22,22,0,0,1145,418,103,624,156,8,0,0,8,148,5,5,0,0,143,51,0,92,"17031842500","842500"
"1304",1408,432,272,154,0,118,160,107,11,12,84,53,53,0,0,976,790,220,30,540,186,117,12,12,93,69,10,5,54,"17031842600","842600"
"1305",2619,1014,805,206,52,547,209,0,0,0,0,209,23,40,146,1605,1169,259,0,910,436,235,87,14,134,201,70,0,131,"17031842800","842800"
"1306",420,266,0,0,0,0,266,0,0,0,0,266,75,0,191,154,67,11,0,56,87,14,14,0,0,73,9,8,56,"17031842900","842900"
"1307",943,565,0,0,0,0,565,16,0,0,16,549,106,32,411,378,136,79,14,43,242,47,13,14,20,195,21,0,174,"17031843000","843000"
"1308",834,239,47,12,0,35,192,18,18,0,0,174,47,12,115,595,227,65,0,162,368,0,0,0,0,368,88,0,280,"17031843100","843100"
"1309",1010,333,125,0,12,113,208,98,43,21,34,110,16,17,77,677,423,170,0,253,254,75,31,0,44,179,39,12,128,"17031843200","843200"
"1310",265,112,0,0,0,0,112,25,0,25,0,87,13,12,62,153,83,30,11,42,70,22,22,0,0,48,48,0,0,"17031843300","843300"
"1311",469,35,11,0,0,11,24,0,0,0,0,24,0,0,24,434,193,33,3,157,241,18,18,0,0,223,47,22,154,"17031843400","843400"
"1312",268,192,106,28,27,51,86,0,0,0,0,86,51,10,25,76,76,14,0,62,0,0,0,0,0,0,0,0,0,"17031843500","843500"
"1313",845,293,31,16,0,15,262,35,0,0,35,227,46,0,181,552,140,35,9,96,412,69,36,0,33,343,53,38,252,"17031843600","843600"
"1314",505,15,15,3,0,12,0,0,0,0,0,0,0,0,0,490,425,188,29,208,65,58,37,0,21,7,0,0,7,"17031843700","843700"
"1315",462,136,12,0,0,12,124,24,24,0,0,100,10,10,80,326,90,32,0,58,236,0,0,0,0,236,93,14,129,"17031843800","843800"
"1316",690,178,0,0,0,0,178,8,0,0,8,170,126,33,11,512,91,42,4,45,421,0,0,0,0,421,88,21,312,"17031843900","843900"
"1317",0,0,0,0,0,0,0,0,0,0,0,0,0,0,0,0,0,0,0,0,0,0,0,0,0,0,0,0,0,"17031980000","980000"
"1318",0,0,0,0,0,0,0,0,0,0,0,0,0,0,0,0,0,0,0,0,0,0,0,0,0,0,0,0,0,"17031980100","980100"
"1319",0,0,0,0,0,0,0,0,0,0,0,0,0,0,0,0,0,0,0,0,0,0,0,0,0,0,0,0,0,"17031990000","990000"
